wid.1	wid.2	amino_acid.1	amino_acid.2
GCTCGGTACAGCTCAGCA	------TTCCGCTCAGCA	ARYSSA	- - F R S A
CTGATAAAGGAGTCT	---ACACTGGAGTCT	MIKES	- T L E S
CCTGGGGAGCTCTCAGCCTCCAGG	------------TCAGGCTTCAGG	PGELSASR	- - - - S G F R
AGCCAAAGTTTTGTC	---CCAAAGTTTGTT	SQSFV	- P K F V
CTCTCTGGCAGCAGGAACAGCAGA	------------AGCAGCAGCAGA	LSGSRNSR	- - - - S S S R
CCCTCTCAGTTGTCATCGGCAAGA	------------TTATCAGCAAGA	PSQLSSAR	- - - - L S A R
AGGTTACAATCCGGT	---TCCCTTTCAGGT	RLQSG	- S L S G
GAAAGTACAATTCTC	---AGAGACGTTCTC	ESTIL	- R D V L
CGAAGAAGAAGCCTG	---AGGAGGAGCCTG	RRRSL	- R R S L
CAGAATATCGAGAAG	---AGAACACAGAAG	QNIEK	- R T Q K
AGCCTGCTTTATCCA	---CCGCTGTATCCA	SLLYP	- P L Y P
CGAAGCTATGGCTAC	---AGCTCTGGCTAC	RSYGY	- S S G Y
AATGCTCTTTCTGTAACCAGT	---------TCTGCGACCAGT	NALSVTS	- - - S A T S
TCCATACCATCAGAT	---AAAGTTTCAGAT	SIPSD	- K V S D
TCTCCTAGCCCAAGGGCA	------AGCCCAAGGGCA	SPSPRA	- - S P R A
ACTATTACAGATGTGGAAGCTGTT	------------GTGATCGCTGCT	TITDVEAV	- - - - V I A A
AGCATAGGCTCTCCAGGC	------GACTTTCCAGAC	SIGSPG	- - D F P D
CTTTTACCTGACACA	---TTACTTGACACA	LLPDT	- L L D T
TCTTTGAGAGGGCTACGA	------AGCCTGGTGTCC	SLRGLR	- - S L V S
NNNNNNTATGGGATCATAAGCCTT	------------ATCATAAGCCTT	XXYGIISL	- - - - I I S L
CCTGAAGTGATTCTA	---GAAGAGATTCTA	PEVIL	- E E I L
TTGATGATTGACCCG	---ATTCTTGACCCG	MMIDP	- I L D P
ACCTCGACTGTCCAT	---TTGGCTGTCCAT	TSTVH	- L A V H
TCCCAGCCGCCTTCA	---CAGCAGCCTTCA	SQPPS	- Q Q P S
CGGAGAAGAGCTGTG	---AGAAGAGCTGTG	RRRAV	- R R A V
AGATCAAGCCAGCAG	---TTAAGCCAGCAG	RSSQQ	- L S Q Q
CGGTCCAGGTCCAGGTCCTTCTCC	------------AGGTCCCTCTCC	RSRSRSFS	- - - - R S L S
TCCAGTTCCAGAAGC	---AGTTCCAGAAGC	SSSRS	- S S R S
GAGCAGCCGCGGGAG	---CCGCTGCGGGAG	EQPRE	- P L R E
AAGAAAGACAAGAAGGAC	------GCCAAGGCAAGT	KKDKKD	- - A K A S
ACTTCAGGAGAGACT	---TTGGAAGAGACT	TSGET	- L E E T
TTGCTGCTGCAGCAG	---CTGCTGCAGCAG	MLLQQ	- L L Q Q
AAGGTCCCGTCTCAG	---GGCCTGTCCCAG	KVPSQ	- G L S Q
AGCTCTGGCAGGAAC	---TCTGACAGGAAC	SSGRN	- S D R N
AGCTCTGGGGACTTG	---TCTGAGGACTTA	SSGDL	- S E D L
AGAGCTCGCCCAACGAGA	------CGCACAATGAGA	RARPTR	- - R T M R
AGCTTGGATGCCCGT	---TCGATTGCCCGT	SLDAR	- S I A R
CGTGGCGTGCCTCCG	---GTCTCGCCCCCA	RGVPP	- V S P P
GACATAGGCAAGGTG	---ATGGTTGAAGTA	DIGKV	- M V E V
CTCCTGGCTCCACTGATC	------GCTCTACTGATC	LLAPLI	- - A L L I
TCGAGCCCCCAGGGA	---AGTTCCCAGGGG	SSPQG	- S S Q G
TTGCTCCTGCTGCTCGGG	------CTGCTGCTTGGG	MLLLLG	- - L L L G
CGGATGGTCTTACATTCA	------GAAGCACACTCG	RMVLHS	- - E A H S
AATGTCATTGATCCC	---GCCGTGGACCCC	NVIDP	- A V D P
TCCAAGTTCAGTAATGATGAC	---------AGCCGTGATGAC	SKFSNDD	- - - S R D D
CAAAAGTCTGATGGTTCT	------TCTAAGGGTTCT	QKSDGS	- - S K G S
CTGTTGTTAGATGAT	---TTGTTAGATGAT	MLLDD	- L L D D
TGCCAGCTGTTGGTC	---CTGGAGTTGGTC	CQLLV	- L E L V
GAAGAGGAAACAGGGAAGTCA	---------ACAGAAAAGTCA	EEETGKS	- - - T E K S
