wid.1	wid.2	amino_acid.1	amino_acid.2
ATGTTTGGTGGGAAA	ATGTTAGGCCGG---	MFGGK	M L G R -
TCCTTTGCATTCTGG	AGTATGCTTGTC---	SFAFW	S M L V -
TGTGGACTTGAAGAC	TGTGAACATGGA---	CGLED	C E H G -
GGAGAAGAAGCCGAAGCA	GGAGAAGAAGCC------	GEEAEA	G E E A - -
GACGACGAGGAGGAA	GACGACGAGGAG---	DDEEE	D D E E -
GAAGTAAAAGTTAAAGTC	GAAGTAAAAGTT------	EVKVKV	E V K V - -
GTCTCCAGCAGCAGT	GTCTCCAGCAGC---	VSSSS	V S S S -
GGAAGTTTTTCCTCA	GGAAGGGATTTC---	GSFSS	G R D F -
CCCGGAGAGGACAGCCGGGAT	CCTGGAAAGGAC---------	PGEDSRD	P G K D - - -
AAAGAGGTGGAGGGT	AAAGAGGAGAAG---	KEVEG	K E E K -
AAGAGCAAGGACNNNNNN	AAGGCTAAGAAC------	KSKDXX	K A K N - -
TGTAGCAGCAGCAGT	TGTAGCAGCAGC---	CSSSS	C S S S -
GCCCAAGAAGAGGAA	TCCCAGGAAGAG---	AQEEE	S Q E E -
TTGCTGCTGCTGCTC	TTGCTGCTGCTG---	MLLLL	L L L L -
ACCGATCTTCCGCCTGCTTCT	ACAGATAGCCAG---------	TDLPPAS	T D S Q - - -
TCTGCCACCACCACCACTACT	TCTGCCACCACC---------	SATTTTT	S A T T - - -
CCTGCCACAGCCGCTACCCCAACT	CCTGCCCCAGCC------------	PATAATPT	P A P A - - - -
CAGCCGGCGGCGGCA	CAGCCAGCGGCG---	QPAAA	Q P A A -
GAGGCAATAGGGTCGGGA	GAGGCAACAGGG------	EAIGSG	E A T G - -
GAATCCGACACGGCA	GAATCCATCCTG---	ESDTA	E S I L -
AAATCTAAGAAGAAA	AAACCTAAGAAG---	KSKKK	K P K K -
CAGCCGCAGCCTCAGCCA	CAGCCCCAGCCT------	QPQPQP	Q P Q P - -
GGATTGCCAACTCAA	GGATTGACAGCT---	GLPTQ	G L T A -
ACCGGGACCCAGGAGGCGACCCAA	ACCGGGACCCAG------------	TGTQEATQ	T G T Q - - - -
GAGGAGGAGGAGGAA	GAGGAGGAGGAG---	EEEEE	E E E E -
TCTTCCCTGCCTCCA	TCTTCCCAGCCT---	SSLPP	S S Q P -
TGCTGGAACCTGTCTCTA	TGCTGGAGCCTG------	CWNLSL	C W S L - -
CAGGCAGGAAAGGAGGGA	GAGGCAGAAGAG------	QAGKEG	E A E E - -
ACATCGAACTTATCGAACCTC	ACATCGAACTTA---------	TSNLSNL	T S N L - - -
CCTTCCAGGGAGCCT	CCTCCAGAGGAG---	PSREP	P P E E -
GAGGAGGAAGAGGAAAATGAGGAA	GAGGAAGAAGAG------------	EEEEENEE	E E E E - - - -
CACTGGGTCCGCAGGCGA	CACTGGTACCGC------	HWVRRR	H W Y R - -
CCAGGGCTACTTCTA	CCAGGGCTCCTT---	PGLLL	P G L L -
AAAGATGGGCCGGGAAAGGCT	AAAGATGAGCTG---------	KDGPGKA	K D E L - - -
ATGCAGCAGCAGCAA	ATGCAACAGCAG---	MQQQQ	M Q Q Q -
AGATGTATGAAACAG	AGATGTAAGGAA---	RCMKQ	R C K E -
GGAGCAGTGGGGAGA	GGGAGCAGTGAG---	GAVGR	G S S E -
ACTGAGACAACAACG	GCTGAGACAACA---	TETTT	A E T T -
GAGGAGGCAGAGGAA	GAAGAGGAAGAG---	EEAEE	E E E E -
TGCAAAGATACCGTTCANNNN	TGCCGAGAGACC---------	CKDTVXX	C R E T - - -
ACACATAGAGATAGAGAC	ACACACAGAGAT------	THRDRD	T H R D - -
TACGACATCGCTAAC	TATGACAACACT---	YDIAN	Y D N T -
CCAAACACGCCAACCACG	CCAAACGCATCA------	PNTPTT	P N A S - -
AGGGTATACCCTTGGCCA	TGGATATGCCCT------	RVYPWP	W I C P - -
CCACCCCCACCCCCACCA	CCACCCCCACCC------	PPPPPP	P P P P - -
GCAGCGGCGGCAGCG	GCGGCGGCGGCA---	AAAAA	A A A A -
GAAGAAGAGGAGGAA	GAGGAAGAGGAG---	EEEEE	E E E E -
CGGGGTCCGGGACCGGGG	CGGGGTCCGGGA------	RGPGPG	R G P G - -
CAGCAGCAGCAGCAGCAGCAACAA	CAGCAGCAGCAG------------	QQQQQQQQ	Q Q Q Q - - - -
CAGCAGCAGCAGCAA	CAGCAGCAGCAG---	QQQQQ	Q Q Q Q -
CCAGGCAGCAGCAGT	CCAGGCAGCAGC---	PGSSS	P G S S -
GTCCACAGCTCCTCT	ATCAACAGCTCC---	VHSSS	I N S S -
TACCAGGAAGAGGAA	TACCAGGAAGAG---	YQEEE	Y Q E E -
CACAGTGACCATGATGACCAC	CACAGTGACCAT---------	HSDHDDH	H S D H - - -
ATTTACCCCCTGTTGCTGCTA	GTCTACCTCCTG---------	IYPLLLL	V Y L L - - -
GCTTCTGCTGCTGCCGCC	GCTGCTGCTGCT------	ASAAAA	A A A A - -
GGACAGGCTGATGCTGACGCTGAC	GAGCAGGCTGAT------------	GQADADAD	E Q A D - - - -
TTTGACTATGGAGAGGAGCATTCG	TTGGATCACGGA------------	FDYGEEHS	L D H G - - - -
GCCATCACTTCAAAAGACAATAAC	GCTGTCAATTCA------------	AITSKDNN	A V N S - - - -
GAAGGAACACTAACACTG	GAAAGAACGCTA------	EGTLTL	E R T L - -
CAGCAGCAACAGCAGCAGCAA	CAGCAGCAACAG---------	QQQQQQQ	Q Q Q Q - - -
GGAGGCCCAGCCGCT	GGAGGCACAGCC---	GGPAA	G G T A -
GACGATATTGACAAT	GACGATGATGAC---	DDIDN	D D D D -
GAACACGAGGAGGAA	GGGCACGAGGAG---	EHEEE	G H E E -
AACGCTAATCGAGAGAAG	AACACTGATGTA------	NANREK	N T D V - -
GGACAAAGCAGGAGCTCC	GGACAAAGCGGG------	GQSRSS	G Q S G - -
GAAGAAGATGAAGAG	GAGGAGGAGGAA---	EEDEE	E E E E -
CCTTACCCTCAGCCTCAA	GCTTACCCTCAG------	PYPQPQ	A Y P Q - -
TTGAAGGTGGAGAAA	CTGAAGGAAGAG---	MKVEK	L K E E -
TATGGGGAAGAGTGC	TATGGGGGAGTG---	YGEEC	Y G G V -
GGTCCTGGAGTCAGAACT	GGTCCTAGAGTC------	GPGVRT	G P R V - -
CCGCAGCCACCGCCGCCACCACCA	CCGCAGGCACCG------------	PQPPPPPP	P Q A P - - - -
CCTGAGGGTCTGCTC	AGCCAGTATCTG---	PEGLL	S Q Y L -
CACTCCCCGAACTTCCTGAGG	CACCACTTTCAC---------	HSPNFLR	H H F H - - -
CAGCGGGAGAAGGAGAAGGAGAAA	CAGAGGGAGAAG------------	QREKEKEK	Q R E K - - - -
GGCGGCGGCGGTGGAGGCGGC	GGCAGTGGCGGT---------	GGGGGGG	G S G G - - -
GCACCTGGAGACGAT	GGGCCTGAAGAC---	APGDD	G P E D -
CAGCAGCAGCAACAGCAG	CAGCAGCAGCAA------	QQQQQQ	Q Q Q Q - -
AGCTCAGGTGGCGGT	AGCTCCGGTGGC---	SSGGG	S S G G -
GAAGACTTAGAGCTTTGGTCAAAA	AAAGACTCAGAG------------	EDLELWSK	K D S E - - - -
AACTCCAGGCAGCCA	GACTCCATGCTG---	NSRQP	D S M L -
GCTGCAGTAGGGGGCAGCGGCGGT	GCTGCAGGAGGG------------	AAVGGSGG	A A G G - - - -
CAGCAGCAGCAGCAGCAGCAACAA	CAACAACAGCAG------------	QQQQQQQQ	Q Q Q Q - - - -
CAGCAGCAGCAGCAA	CAGCAGCAGCAG---	QQQQQ	Q Q Q Q -
GGGTTCATCAGGGATGGGATCAGC	GCGCTCGTTGGG------------	GFIRDGIS	A L V G - - - -
AAGCCCCCGGGTGCGGGTGCGGGC	AAGCCCTCGGGT------------	KPPGAGAG	K P S G - - - -
TGCCCGCCGCCGCCA	TGCCCACCGCCG---	CPPPP	C P P P -
AGGCCGCCTGGTGCGGTG	GAGCCCTGTGCT------	RPPGAV	E P C A - -
CACCAGCAGCAGCAA	CACCAGCAGCAG---	HQQQQ	H Q Q Q -
GGAGGCCACAAACAACCTAAC	GGAGGCCCCAAA---------	GGHKQPN	G G P K - - -
CATCACGGAGAGGAC	CATCATGAAGAG---	HHGED	H H E E -
AGAAGACATTTCTTT	AGAAGATATTTC---	RRHFF	R R Y F -
TATGAGTACTTTGACAACGTA	TATGAGAACTAT---------	YEYFDNV	Y E N Y - - -
GTGGCTTCCGGCCCCTCA	GTGGCTCCTGAC------	VASGPS	V A P D - -
CAGAACTACTCTTCC	CAGAACTCCTCT---	QNYSS	Q N S S -
CCTCATCTCCCCACT	CTTTATCACGCC---	PHLPT	L Y H A -
ACGCAGCCGAGATCAAGG	ACGCAGCAGCGA------	TQPRSR	T Q Q R - -
GTCACTGTGCAGCCTGTCTGA	GTCACTGTGTAG---------	VTVQPV*	V T V * - - -
CCTCCCACAACAACCACC	CCTCCCACAACA------	PPTTTT	P P T T - -
GCGGAGGAGGAGGAA	GCGGAAGAGGAG---	AEEEE	A E E E -
CCGGGCCCGCCGCCT	CCGGGCCCGCCG---	PGPPP	P G P P -
GACCACAGCTCCTCA	GACCACAACTCC---	DHSSS	D H N S -
ACCGTGCCTCCTCCA	ACCGTGCCTCCT---	TVPPP	T V P P -
AAGAAGGCGGCGGCA	AAGAAGGCGGCG---	KKAAA	K K A A -
TCACCAACGCCTCCG	TCACCACCGCCT---	SPTPP	S P P P -
CTCTGCAAGAATTCC	CTCTGCAATATT---	LCKNS	L C N I -
GAAGGTAAGAAGATGCACAGGGCC	GAGGGTCCCCTG------------	EGKKMHRA	E G P L - - - -
CAGAGCGAAGAGGAA	AACAGCGATGAG---	QSEEE	N S D E -
GAACTCAAGAAGAAA	CAGCTCAAGAAG---	ELKKK	Q L K K -
GAGGAAGAGGAGGAA	GAGGAAGAGGAG---	EEEEE	E E E E -
AATGATGGTGAAGAG	AACGATGATGAA---	NDGEE	N D D E -
GGGCCTACTTTGCACCTC	GCACCTCGTTTG------	GPTLHL	A P R L - -
AGTGAGGAGGAGGAA	AGTGAGGAGGAG---	SEEEE	S E E E -
AAAGAGAAGAAAAAG	AAAGAGAAGAAA---	KEKKK	K E K K -
AGTCCCATGGGAATGTGGCCT	TCTCCTTACGAA---------	SPMGMWP	S P Y E - - -
CCTTGCCACAACCTACCCAGCCAG	GGCGGGTCCGCC------------	PCHNLPSQ	G G S A - - - -
AACGCTCCTCCTCCG	AATGCTCCCCCT---	NAPPP	N A P P -
CCAGAACCACGTCCACGCCCACGC	CCAGAACCCCGT------------	PEPRPRPR	P E P R - - - -
CAGCAGCAGCCGGCA	CAGCAGCCCCCG---	QQQPA	Q Q P P -
AGCCTGCCTTCATCC	GGCCTGACTTCA---	SLPSS	G L T S -
TCCTCTTCCTCTTCC	TCTTCTTCCTCT---	SSSSS	S S S S -
CTGCAGCATGTGCAAGATCAAGCA	CTGCAGCAGCTG------------	MQHVQDQA	L Q Q L - - - -
ACAGGTGAAAACGACGATGAAAAT	ACAGGCGAAGGC------------	TGENDDEN	T G E G - - - -
ATCTTGGCTGCAGCT	ATCTTGGCTGCA---	ILAAA	I L A A -
GATGTGACTAGCAAT	GATGTGCCTGGC---	DVTSN	D V P G -
GGGGACGCAGCAGCC	GGGGACGCTGCA---	GDAAA	G D A A -
ATCTCCACAGCTGCA	ATCTCTGCAGCT---	ISTAA	I S A A -
CAGGTCCCAGCTGGCCATAGCCAG	CAGGTCTCGTCT------------	QVPAGHSQ	Q V S S - - - -
CCTGCATCCAGCAGT	CCTGCATCCAGC---	PASSS	P A S S -
