wid.1	wid.2	amino_acid.1	amino_acid.2
ATGTTTGGTGGGAAA	ATGTTA---GGCCGG	MFGGK	M L - G R
TCCTTTGCATTCTGG	AGTATG---CTTGTC	SFAFW	S M - L V
TGTGGACTTGAAGAC	TGTGAA---CATGGA	CGLED	C E - H G
GGAGAAGAAGCCGAAGCA	GGAGAA------GAAGCC	GEEAEA	G E - - E A
GACGACGAGGAGGAA	GACGAC---GAGGAG	DDEEE	D D - E E
GAAGTAAAAGTTAAAGTC	GAAGTA------AAAGTT	EVKVKV	E V - - K V
GTCTCCAGCAGCAGT	GTCTCC---AGCAGC	VSSSS	V S - S S
GGAAGTTTTTCCTCA	GGAAGG---GATTTC	GSFSS	G R - D F
CCCGGAGAGGACAGCCGGGAT	CCTGGA---------AAGGAC	PGEDSRD	P G - - - K D
AAAGAGGTGGAGGGT	AAAGAG---GAGAAG	KEVEG	K E - E K
AAGAGCAAGGACNNNNNN	AAGGCT------AAGAAC	KSKDXX	K A - - K N
TGTAGCAGCAGCAGT	TGTAGC---AGCAGC	CSSSS	C S - S S
GCCCAAGAAGAGGAA	TCCCAG---GAAGAG	AQEEE	S Q - E E
TTGCTGCTGCTGCTC	TTGCTG---CTGCTG	MLLLL	L L - L L
ACCGATCTTCCGCCTGCTTCT	ACAGAT---------AGCCAG	TDLPPAS	T D - - - S Q
TCTGCCACCACCACCACTACT	TCTGCC---------ACCACC	SATTTTT	S A - - - T T
CCTGCCACAGCCGCTACCCCAACT	CCTGCC------------CCAGCC	PATAATPT	P A - - - - P A
CAGCCGGCGGCGGCA	CAGCCA---GCGGCG	QPAAA	Q P - A A
GAGGCAATAGGGTCGGGA	GAGGCA------ACAGGG	EAIGSG	E A - - T G
GAATCCGACACGGCA	GAATCC---ATCCTG	ESDTA	E S - I L
AAATCTAAGAAGAAA	AAACCT---AAGAAG	KSKKK	K P - K K
CAGCCGCAGCCTCAGCCA	CAGCCC------CAGCCT	QPQPQP	Q P - - Q P
GGATTGCCAACTCAA	GGATTG---ACAGCT	GLPTQ	G L - T A
ACCGGGACCCAGGAGGCGACCCAA	ACCGGG------------ACCCAG	TGTQEATQ	T G - - - - T Q
GAGGAGGAGGAGGAA	GAGGAG---GAGGAG	EEEEE	E E - E E
TCTTCCCTGCCTCCA	TCTTCC---CAGCCT	SSLPP	S S - Q P
TGCTGGAACCTGTCTCTA	TGCTGG------AGCCTG	CWNLSL	C W - - S L
CAGGCAGGAAAGGAGGGA	GAGGCA------GAAGAG	QAGKEG	E A - - E E
ACATCGAACTTATCGAACCTC	ACATCG---------AACTTA	TSNLSNL	T S - - - N L
CCTTCCAGGGAGCCT	CCTCCA---GAGGAG	PSREP	P P - E E
GAGGAGGAAGAGGAAAATGAGGAA	GAGGAA------------GAAGAG	EEEEENEE	E E - - - - E E
CACTGGGTCCGCAGGCGA	CACTGG------TACCGC	HWVRRR	H W - - Y R
CCAGGGCTACTTCTA	CCAGGG---CTCCTT	PGLLL	P G - L L
AAAGATGGGCCGGGAAAGGCT	AAAGAT---------GAGCTG	KDGPGKA	K D - - - E L
ATGCAGCAGCAGCAA	ATGCAA---CAGCAG	MQQQQ	M Q - Q Q
AGATGTATGAAACAG	AGATGT---AAGGAA	RCMKQ	R C - K E
GGAGCAGTGGGGAGA	GGGAGC---AGTGAG	GAVGR	G S - S E
ACTGAGACAACAACG	GCTGAG---ACAACA	TETTT	A E - T T
GAGGAGGCAGAGGAA	GAAGAG---GAAGAG	EEAEE	E E - E E
TGCAAAGATACCGTTCANNNN	TGCCGA---------GAGACC	CKDTVXX	C R - - - E T
ACACATAGAGATAGAGAC	ACACAC------AGAGAT	THRDRD	T H - - R D
TACGACATCGCTAAC	TATGAC---AACACT	YDIAN	Y D - N T
CCAAACACGCCAACCACG	CCAAAC------GCATCA	PNTPTT	P N - - A S
AGGGTATACCCTTGGCCA	TGGATA------TGCCCT	RVYPWP	W I - - C P
CCACCCCCACCCCCACCA	CCACCC------CCACCC	PPPPPP	P P - - P P
GCAGCGGCGGCAGCG	GCGGCG---GCGGCA	AAAAA	A A - A A
GAAGAAGAGGAGGAA	GAGGAA---GAGGAG	EEEEE	E E - E E
CGGGGTCCGGGACCGGGG	CGGGGT------CCGGGA	RGPGPG	R G - - P G
CAGCAGCAGCAGCAGCAGCAACAA	CAGCAG------------CAGCAG	QQQQQQQQ	Q Q - - - - Q Q
CAGCAGCAGCAGCAA	CAGCAG---CAGCAG	QQQQQ	Q Q - Q Q
CCAGGCAGCAGCAGT	CCAGGC---AGCAGC	PGSSS	P G - S S
GTCCACAGCTCCTCT	ATCAAC---AGCTCC	VHSSS	I N - S S
TACCAGGAAGAGGAA	TACCAG---GAAGAG	YQEEE	Y Q - E E
CACAGTGACCATGATGACCAC	CACAGT---------GACCAT	HSDHDDH	H S - - - D H
ATTTACCCCCTGTTGCTGCTA	GTCTAC---------CTCCTG	IYPLLLL	V Y - - - L L
GCTTCTGCTGCTGCCGCC	GCTGCT------GCTGCT	ASAAAA	A A - - A A
GGACAGGCTGATGCTGACGCTGAC	GAGCAG------------GCTGAT	GQADADAD	E Q - - - - A D
TTTGACTATGGAGAGGAGCATTCG	TTGGAT------------CACGGA	FDYGEEHS	L D - - - - H G
GCCATCACTTCAAAAGACAATAAC	GCTGTC------------AATTCA	AITSKDNN	A V - - - - N S
GAAGGAACACTAACACTG	GAAAGA------ACGCTA	EGTLTL	E R - - T L
CAGCAGCAACAGCAGCAGCAA	CAGCAG---------CAACAG	QQQQQQQ	Q Q - - - Q Q
GGAGGCCCAGCCGCT	GGAGGC---ACAGCC	GGPAA	G G - T A
GACGATATTGACAAT	GACGAT---GATGAC	DDIDN	D D - D D
GAACACGAGGAGGAA	GGGCAC---GAGGAG	EHEEE	G H - E E
AACGCTAATCGAGAGAAG	AACACT------GATGTA	NANREK	N T - - D V
GGACAAAGCAGGAGCTCC	GGACAA------AGCGGG	GQSRSS	G Q - - S G
GAAGAAGATGAAGAG	GAGGAG---GAGGAA	EEDEE	E E - E E
CCTTACCCTCAGCCTCAA	GCTTAC------CCTCAG	PYPQPQ	A Y - - P Q
TTGAAGGTGGAGAAA	CTGAAG---GAAGAG	MKVEK	L K - E E
TATGGGGAAGAGTGC	TATGGG---GGAGTG	YGEEC	Y G - G V
GGTCCTGGAGTCAGAACT	GGTCCT------AGAGTC	GPGVRT	G P - - R V
CCGCAGCCACCGCCGCCACCACCA	CCGCAG------------GCACCG	PQPPPPPP	P Q - - - - A P
CCTGAGGGTCTGCTC	AGCCAG---TATCTG	PEGLL	S Q - Y L
CACTCCCCGAACTTCCTGAGG	CACCAC---------TTTCAC	HSPNFLR	H H - - - F H
CAGCGGGAGAAGGAGAAGGAGAAA	CAGAGG------------GAGAAG	QREKEKEK	Q R - - - - E K
GGCGGCGGCGGTGGAGGCGGC	GGCAGT---------GGCGGT	GGGGGGG	G S - - - G G
GCACCTGGAGACGAT	GGGCCT---GAAGAC	APGDD	G P - E D
CAGCAGCAGCAACAGCAG	CAGCAG------CAGCAA	QQQQQQ	Q Q - - Q Q
AGCTCAGGTGGCGGT	AGCTCC---GGTGGC	SSGGG	S S - G G
GAAGACTTAGAGCTTTGGTCAAAA	AAAGAC------------TCAGAG	EDLELWSK	K D - - - - S E
AACTCCAGGCAGCCA	GACTCC---ATGCTG	NSRQP	D S - M L
GCTGCAGTAGGGGGCAGCGGCGGT	GCTGCA------------GGAGGG	AAVGGSGG	A A - - - - G G
CAGCAGCAGCAGCAGCAGCAACAA	CAACAA------------CAGCAG	QQQQQQQQ	Q Q - - - - Q Q
CAGCAGCAGCAGCAA	CAGCAG---CAGCAG	QQQQQ	Q Q - Q Q
GGGTTCATCAGGGATGGGATCAGC	GCGCTC------------GTTGGG	GFIRDGIS	A L - - - - V G
AAGCCCCCGGGTGCGGGTGCGGGC	AAGCCC------------TCGGGT	KPPGAGAG	K P - - - - S G
TGCCCGCCGCCGCCA	TGCCCA---CCGCCG	CPPPP	C P - P P
AGGCCGCCTGGTGCGGTG	GAGCCC------TGTGCT	RPPGAV	E P - - C A
CACCAGCAGCAGCAA	CACCAG---CAGCAG	HQQQQ	H Q - Q Q
GGAGGCCACAAACAACCTAAC	GGAGGC---------CCCAAA	GGHKQPN	G G - - - P K
CATCACGGAGAGGAC	CATCAT---GAAGAG	HHGED	H H - E E
AGAAGACATTTCTTT	AGAAGA---TATTTC	RRHFF	R R - Y F
TATGAGTACTTTGACAACGTA	TATGAG---------AACTAT	YEYFDNV	Y E - - - N Y
GTGGCTTCCGGCCCCTCA	GTGGCT------CCTGAC	VASGPS	V A - - P D
CAGAACTACTCTTCC	CAGAAC---TCCTCT	QNYSS	Q N - S S
CCTCATCTCCCCACT	CTTTAT---CACGCC	PHLPT	L Y - H A
ACGCAGCCGAGATCAAGG	ACGCAG------CAGCGA	TQPRSR	T Q - - Q R
GTCACTGTGCAGCCTGTCTGA	GTCACT---------GTGTAG	VTVQPV*	V T - - - V *
CCTCCCACAACAACCACC	CCTCCC------ACAACA	PPTTTT	P P - - T T
GCGGAGGAGGAGGAA	GCGGAA---GAGGAG	AEEEE	A E - E E
CCGGGCCCGCCGCCT	CCGGGC---CCGCCG	PGPPP	P G - P P
GACCACAGCTCCTCA	GACCAC---AACTCC	DHSSS	D H - N S
ACCGTGCCTCCTCCA	ACCGTG---CCTCCT	TVPPP	T V - P P
AAGAAGGCGGCGGCA	AAGAAG---GCGGCG	KKAAA	K K - A A
TCACCAACGCCTCCG	TCACCA---CCGCCT	SPTPP	S P - P P
CTCTGCAAGAATTCC	CTCTGC---AATATT	LCKNS	L C - N I
GAAGGTAAGAAGATGCACAGGGCC	GAGGGT------------CCCCTG	EGKKMHRA	E G - - - - P L
CAGAGCGAAGAGGAA	AACAGC---GATGAG	QSEEE	N S - D E
GAACTCAAGAAGAAA	CAGCTC---AAGAAG	ELKKK	Q L - K K
GAGGAAGAGGAGGAA	GAGGAA---GAGGAG	EEEEE	E E - E E
AATGATGGTGAAGAG	AACGAT---GATGAA	NDGEE	N D - D E
GGGCCTACTTTGCACCTC	GCACCT------CGTTTG	GPTLHL	A P - - R L
AGTGAGGAGGAGGAA	AGTGAG---GAGGAG	SEEEE	S E - E E
AAAGAGAAGAAAAAG	AAAGAG---AAGAAA	KEKKK	K E - K K
AGTCCCATGGGAATGTGGCCT	TCTCCT---------TACGAA	SPMGMWP	S P - - - Y E
CCTTGCCACAACCTACCCAGCCAG	GGCGGG------------TCCGCC	PCHNLPSQ	G G - - - - S A
AACGCTCCTCCTCCG	AATGCT---CCCCCT	NAPPP	N A - P P
CCAGAACCACGTCCACGCCCACGC	CCAGAA------------CCCCGT	PEPRPRPR	P E - - - - P R
CAGCAGCAGCCGGCA	CAGCAG---CCCCCG	QQQPA	Q Q - P P
AGCCTGCCTTCATCC	GGCCTG---ACTTCA	SLPSS	G L - T S
TCCTCTTCCTCTTCC	TCTTCT---TCCTCT	SSSSS	S S - S S
CTGCAGCATGTGCAAGATCAAGCA	CTGCAG------------CAGCTG	MQHVQDQA	L Q - - - - Q L
ACAGGTGAAAACGACGATGAAAAT	ACAGGC------------GAAGGC	TGENDDEN	T G - - - - E G
ATCTTGGCTGCAGCT	ATCTTG---GCTGCA	ILAAA	I L - A A
GATGTGACTAGCAAT	GATGTG---CCTGGC	DVTSN	D V - P G
GGGGACGCAGCAGCC	GGGGAC---GCTGCA	GDAAA	G D - A A
ATCTCCACAGCTGCA	ATCTCT---GCAGCT	ISTAA	I S - A A
CAGGTCCCAGCTGGCCATAGCCAG	CAGGTC------------TCGTCT	QVPAGHSQ	Q V - - - - S S
CCTGCATCCAGCAGT	CCTGCA---TCCAGC	PASSS	P A - S S
