wid.1	wid.2	amino_acid.1	amino_acid.2
CTGCCGCTCCTGAGGCCT	CTGGCAACCCGG------	MPLLRP	L A T R - -
GAGCACCAGGAGGAA	GAACACCAGGAG---	EHQEE	E H Q E -
AGGGGACCTGGGGGT	AGGGGGTCTGGG---	RGPGG	R G S G -
ACTTCAACACCCACTCCAACTCCA	ACTTCAATACCC------------	TSTPTPTP	T S I P - - - -
CCTTATTCTTCCTCTTCTTCCTCT	CCTTATTCTTCC------------	PYSSSSSS	P Y S S - - - -
TGCTCCAATATCACTCAG	TGCTCCAGCTCC------	CSNITQ	C S S S - -
ATGTTTGGTGGGAAA	ATGTTAGGCCGG---	MFGGK	M L G R -
TCACAAGTAAGCTGGGATCAATCT	TCACAAGAAAGC------------	SQVSWDQS	S Q E S - - - -
TGTGGACTTGAAGAC	TGTGAACATGGA---	CGLED	C E H G -
GGAGAAGAAGCCGAAGCA	GGAGAAGAAGCC------	GEEAEA	G E E A - -
GACGACGAGGAGGAA	GACGACGAGGAG---	DDEEE	D D E E -
GTTGGCGTGCTTTTC	CATGGTTGGCGT---	VGVLF	H G W R -
ATGAATGAAAAGGATGAGAAA	ATGAATGAAAAG---------	MNEKDEK	M N E K - - -
ACCAGGGCTGCTGCC	ACCAGGACTGCT---	TRAAA	T R T A -
ACAGAAGGCCCGGCA	GGGGAAGTCCTG---	TEGPA	G E V L -
GTGGAGGGTGAAGGAATTGTTACT	GAGAAGGCTGGA------------	VEGEGIVT	E K A G - - - -
GAGAAGGAAGAAGAG	GAGAAGGAGGAA---	EKEEE	E K E E -
GGCTGCGGCGGCGGT	GGCTGCGGCAGC---	GCGGG	G C G S -
GCCCTCGACGATGCA	GCCCTTGACGTT---	ALDDA	A L D V -
GCGGCCGTGGAGGTTTCT	GCGGCGGTGGTG------	AAVEVS	A A V V - -
GATGAGCCGGCCACACCGCCCTCT	AACGAGCAAGGC------------	DEPATPPS	N E Q G - - - -
GCCCAGTCCTCTTCCTCC	GCCCAGACCTCT------	AQSSSS	A Q T S - -
ATAAGTTTAGGGGAC	AAAAGTAAAAGG---	ISLGD	K S K R -
CGTTCCTCCAGAAGCCGC	CGTTCCTCCAGA------	RSSRSR	R S S R - -
TCCCACCCAGAGCGC	TCCTACCAAGAG---	SHPER	S Y Q E -
TCTGCCACCACCACCACTACT	TCTGCCACCACC---------	SATTTTT	S A T T - - -
CCCCCAAGCAGCAGT	CCCCCGAGCAGC---	PPSSS	P P S S -
CAGTCCACCACCACT	CAGTCCACCACC---	QSTTT	Q S T T -
CCCACTCCTCCACCGCCT	CCTACTCCTCCA------	PTPPPP	P T P P - -
GTAGAGCGGTCACTCACC	GCAGAGCAGTCA------	VERSLT	A E Q S - -
AAGACTTTCCATTTCCAC	AAGTCTTTCCAT------	KTFHFH	K S F H - -
GCGTTGCCGCCGCCA	GCGTTGCCACCG---	ALPPP	A L P P -
CCTGCCACAGCCGCTACCCCAACT	CCTGCCCCAGCC------------	PATAATPT	P A P A - - - -
CACCTTGATGATGAC	CACCTTGATGAT---	HLDDD	H L D D -
CAGCCGGCGGCGGCA	CAGCCAGCGGCG---	QPAAA	Q P A A -
AAATTTCCAATCGAGACGCCA	TATTTTTCCTAC---------	KFPIETP	Y F S Y - - -
AGCTTCGGGGAGGAA	AGCTTCAGGGAG---	SFGEE	S F R E -
GCAGGAGAGGAAGAG	GCAGGAGAGGAA---	AGEEE	A G E E -
CATGGCTCCAGCTCTTCT	CATGGCTCCAGC------	HGSSSS	H G S S - -
GAGGCAATAGGGTCGGGA	GAGGCAACAGGG------	EAIGSG	E A T G - -
CAGGCTGTGATGAGT	CAGGCTGATGAG---	QAVMS	Q A D E -
AAATCTAAGAAGAAA	AAACCTAAGAAG---	KSKKK	K P K K -
ACTACCCCAGGGACTGTGCCAGCA	ACACACCTCCAG------------	TTPGTVPA	T H L Q - - - -
GAACCTACTACTACA	GAACCTACCACT---	EPTTT	E P T T -
AAGGATTTGTGCTCT	AGGGGTGCCAGC---	KDLCS	R G A S -
CAGCTGCAGCAGCAGCAGCAA	CAGTTGCAGCAG---------	QLQQQQQ	Q L Q Q - - -
CCCGTGTTCCCTTGC	CCCGTTTCCCTT---	PVFPC	P V S L -
GGATTGCCAACTCAA	GGATTGACAGCT---	GLPTQ	G L T A -
ACGCAGCCCTCGCTGCCCTCT	ACGCAGCCCTCG---------	TQPSLPS	T Q P S - - -
AAACCTCTTGAGTGCGGC	GGGACTCTGGTG------	KPLECG	G T L V - -
CGCAGCGCGGCGGCC	CACTCCCTTGAG---	RSAAA	H S L E -
TTAGCCCCCCCACCG	GTAGCTCCCCCA---	LAPPP	V A P P -
ACTCCAAAGAAGAAA	ATTCCAAAGAAG---	TPKKK	I P K K -
CCTCCCGAGGAAGAGGAG	CCTCCCGAGGAA------	PPEEEE	P P E E - -
ACCGGGACCCAGGAGGCGACCCAA	ACCGGGACCCAG------------	TGTQEATQ	T G T Q - - - -
TCTTCCCTGCCTCCA	TCTTCCCAGCCT---	SSLPP	S S Q P -
CAGCAGCCGCCGCCA	CCGCAGCCACCG---	QQPPP	P Q P P -
CACACACCGCCGCCC	CACTCACCACCG---	HTPPP	H S P P -
TGCTGGAACCTGTCTCTA	TGCTGGAGCCTG------	CWNLSL	C W S L - -
GGTAGTGGCGGTGGC	GGTAGTGGCGGT---	GSGGG	G S G G -
AATGCAGGCACAGGCTCG	AATGCAGGCACA------	NAGTGS	N A G T - -
GAACAGGAGGAGGAGGAGGAA	GAACAGGAGGAG---------	EQEEEEE	E Q E E - - -
GAGGAGGAAGAGGAAAATGAGGAA	GAGGAAGAAGAG------------	EEEEENEE	E E E E - - - -
AAACGTAAACTTAGC	AAGCATGAACAT---	KRKLS	K H E H -
GCAGAGGAGGAAGATGAAGAG	GCAGAGGAGGAA---------	AEEEDEE	A E E E - - -
GAGCAAGACGACGAT	GAGCAAGATGAC---	EQDDD	E Q D D -
CCAGGGCTACTTCTA	CCAGGGCTCCTT---	PGLLL	P G L L -
CCTGAAGCAGCCCGT	CGTGAAGCAGCC---	PEAAR	R E A A -
AAAGATGGGCCGGGAAAGGCT	AAAGATGAGCTG---------	KDGPGKA	K D E L - - -
GGTGCCGAAAGCAGA	AATGTGGCTAAC---	GAESR	N V A N -
CCTGATGAAGAAGAG	CCTGATGAAGAA---	PDEEE	P D E E -
GAAGGAGATGAAGAG	GAAGGAGATGAA---	EGDEE	E G D E -
AAACAAGAAGAAGAG	AAACAAGAAAAA---	KQEEE	K Q E K -
CGAGCTGGAGGCGGG	CGAGCTGGAGGC---	RAGGG	R A G G -
CACGAGAGCAGCAGT	CGCGAGTGCAGC---	HESSS	R E C S -
GAGCTGGAAGAGGAA	GAGCTGGAAGAG---	ELEEE	E L E E -
GCACCACAGGAAGAG	GCACCACAGGAA---	APQEE	A P Q E -
ACACATAGAGATAGAGAC	ACACACAGAGAT------	THRDRD	T H R D - -
CTGAGCGCAGCGGCC	CTGAGCGCAGCG---	MSAAA	L S A A -
CCTCACACAGCCAGCCCTCCAGCA	CCCCACACAGCC------------	PHTASPPA	P H T A - - - -
GAGACAGAGGAAGAG	GAGACAGAGGAA---	ETEEE	E T E E -
TACGACATCGCTAAC	TATGACAACACT---	YDIAN	Y D N T -
GGCGGCGGCGGCGCGGGCGGA	GGCGGCGCGGGC---------	GGGGAGG	G G A G - - -
CCAAACACGCCAACCACG	CCAAACGCATCA------	PNTPTT	P N A S - -
AGCGGTGCCAGCGCCAGT	AGCGGTGCTAGC------	SGASAS	S G A S - -
AGCAAAGAGGAAGAG	AGCAAAGAGGAA---	SKEEE	S K E E -
GAGAAGGAAGAGGAA	GAGAAGGAAGAG---	EKEEE	E K E E -
GGTGACGGCGGCGGG	GGCGATGGCGGC---	GDGGG	G D G G -
GTGGGGGATGACGAT	GTGGGGGATGAC---	VGDDD	V G D D -
GAAAATGTATCTGCG	GCAGAGGACAGT---	ENVSA	A E D S -
GAGGGAGAGGAAGAG	GAGGGAGAGGAA---	EGEEE	E G E E -
GAAGGGGAGGAGGAA	GAAGGGGAGGAG---	EGEEE	E G E E -
CCGGCTCCACCTCCACCC	CCGGCCCCACCT------	PAPPPP	P A P P - -
AAGTCACTACCACTGCAG	GAGTCCCTGGCA------	KSLPLQ	E S L A - -
TACTACGCCGCGGCA	ACCTACGCCGCG---	YYAAA	T Y A A -
GCAGGGGCGGCGGCGGCA	GCGGGGGCAGCG------	AGAAAA	A G A A - -
GACTACGGAGGTGGA	GAGTACGGCGGT---	DYGGG	E Y G G -
GAAGACAACAAGGAGAACAAA	GAAGACAACAAG---------	EDNKENK	E D N K - - -
TCCCAGTCAGGGTCAGGA	TCACAGTCAGGG------	SQSGSG	S Q S G - -
GCATCCACCACCACT	GCATCTACCACC---	ASTTT	A S T T -
CACCCGGAAGAGGAA	CACCCGGAAGAG---	HPEEE	H P E E -
GCGGAAGAGGACGAGGAT	GCCGAGGAGGAC------	AEEDED	A E E D - -
GTTATTCCACCTCCC	GTTATTCCACCT---	VIPPP	V I P P -
GATGAAGAGGATGAGGAC	GATGAGGAGGAT------	DEEDED	D E E D - -
GCCGCTGAGGACGAT	GCCACCGAGGAC---	AAEDD	A T E D -
TCCACCCCGCCCCCGCCCCCGCCG	TCCACCCCTCCC------------	STPPPPPP	S T P P - - - -
CCCGGCGTGCCGTCC	CGTGACCGTCTG---	PGVPS	R D R L -
GGAAACAGCCCTCCAGCCAGTGAG	GGAAACAGCTCT------------	GNSPPASE	G N S S - - - -
GGATCCGGGGGAGGC	GGATCTGGGGGA---	GSGGG	G S G G -
CTGCTGGCTGCTGCC	CTTCTGGCTGCT---	MLAAA	L L A A -
GAGGATGAAGACACA	GAGGACGAAGAC---	EDEDT	E D E D -
AAAGAGAAAAAGAAA	AAAGAGAAAAAG---	KEKKK	K E K K -
CCATATGCTCAGGCTCAA	CCATATGCCCAG------	PYAQAQ	P Y A Q - -
TTTTCAGAAGTAGCACGC	TTCGGAATAGCA------	FSEVAR	F G I A - -
CACCAAGGCTCTAGGAAGCAG	CACAAACGCTCT---------	HQGSRKQ	H K R S - - -
CACTTCTTGTTGTTA	CACTTCTTGTTG---	HFLLL	H F L L -
CGGGGAATCCGAAGTCGG	GGGGGAAGCCGA------	RGIRSR	G G S R - -
AGTCCTTGCGGTCAGAAG	AGTCCTTACCGT------	SPCGQK	S P Y R - -
CTGAAGGCGGGAACC	CTGGAGGCAGGA---	MKAGT	L E A G -
GCGACCGCGGCGGCC	GCGACCGCGGCG---	ATAAA	A T A A -
AGCGCGCAGCAGCAA	AGCGCGCAGCAG---	SAQQQ	S A Q Q -
AAGGTGAGGACTGTG	AAGATCGTGGCT---	KVRTV	K I V A -
AAACATTGTGACCAA	AAGTACGGAGTC---	KHCDQ	K Y G V -
TTTGGGACAAAATAC	TTTGGGAGGCAA---	FGTKY	F G R Q -
GAAGACGAGGACGAT	GAAGACGAGGAC---	EDEDD	E D E D -
TCAGGTGCTGGAAGT	TCAGGTGGTGGA---	SGAGS	S G G G -
CCAGGCAGCAGCAGT	CCAGGCAGCAGC---	PGSSS	P G S S -
TCTGTACTGACAAAG	TCTGAAGTGACA---	SVLTK	S E V T -
CGCAGCGGTCTGCTA	CGCAGCCGCCTG---	RSGLL	R S R L -
CAGCGGCAGCAGCAA	CAGCGGCAGCAG---	QRQQQ	Q R Q Q -
CCCCGCGGCGGCGGCGGCGGCGGT	CCCCGCGGCGGC------------	PRGGGGGG	P R G G - - - -
TACCAGGAAGAGGAA	TACCAGGAAGAG---	YQEEE	Y Q E E -
CAAGGAACCCCCGGGGCT	CAAGGAGCCCTC------	QGTPGA	Q G A L - -
CACAGTGACCATGATGACCAC	CACAGTGACCAT---------	HSDHDDH	H S D H - - -
ATTTACCCCCTGTTGCTGCTA	GTCTACCTCCTG---------	IYPLLLL	V Y L L - - -
GAGAATCGTGAGTGGGTTCGTGCT	GAGAATCTCCTG------------	ENREWVRA	E N L L - - - -
GGCTCCGCCGCTGCCGCC	GGCTCCGCCGCT------	GSAAAA	G S A A - -
CTCAAGGATGCTCGTTCG	TTACAAAAGGTT------	LKDARS	L Q K V - -
GGACAGGCTGATGCTGACGCTGAC	GAGCAGGCTGAT------------	GQADADAD	E Q A D - - - -
GCACAGGTGCGGTCC	TCTCAGGAAGGG---	AQVRS	S Q E G -
AGACAGAGTGTGGATTCT	GAAAAACAAGAG------	RQSVDS	E K Q E - -
GGGAAAGCAGCTGCA	GGGACAGCAGCT---	GKAAA	G T A A -
CTCCTCATCCTTCTC	CTCTTCATCCTT---	LLILL	L F I L -
GGGGCGCCACTTGTACATGAGATC	AGTTCCCAATCT------------	GAPLVHEI	S S Q S - - - -
TCAAGAGAGGAAGAG	TCAAGAGAGGAA---	SREEE	S R E E -
GGTTCAGGGTCACCT	GGTTCAGGGTCA---	GSGSP	G S G S -
GAGGCGAAGGTCAAGGTG	GAGTCGAAGGTC------	EAKVKV	E S K V - -
GCCATCACTTCAAAAGACAATAAC	GCTGTCAATTCA------------	AITSKDNN	A V N S - - - -
GAAGGAACACTAACACTG	GAAAGAACGCTA------	EGTLTL	E R T L - -
GCTACTGCTGCTGCC	GCTACTGCTGCT---	ATAAA	A T A A -
CATCACCAGCAACAG	CACCACCACCAA---	HHQQQ	H H H Q -
TCGGACTCCAGCTCG	TCAGACTCCAGC---	SDSSS	S D S S -
AAAGACAAGGGCAGGGGCAAGGGT	AAAGAGAAGGGC------------	KDKGRGKG	K E K G - - - -
AAAAAAGATGCAACG	AAGAAAGGCTTA---	KKDAT	K K G L -
TCCATCTCCTCGTCCTCC	TCCATCTCCTCG------	SISSSS	S I S S - -
GAACACGAGGAGGAA	GGGCACGAGGAG---	EHEEE	G H E E -
GATTGCAGCAGCAGT	GATCACAGCGGC---	DCSSS	D H S G -
ATGATGTCCAGTTCA	ATGGTGTCCAGT---	MMSSS	M V S S -
CATCGACAGCAGCAGCAA	CATCGACAGCAG------	HRQQQQ	H R Q Q - -
CACCCGGAAGAGGAA	CACCCGGAAGAG---	HPEEE	H P E E -
GGCATTGTGGCCAAG	AACCTTGGAGGC---	GIVAK	N L G G -
GACAGTTACAACCGCCTCAAGAGT	GACGGGCGCCCC------------	DSYNRLKS	D G R P - - - -
TCTGGCCTAGCACAAATTGAG	GCTGACCTGGCA---------	SGLAQIE	A D L A - - -
GAGGAGGCGGCGGCA	GAGGAGGCTGTG---	EEAAA	E E A V -
GGCAGCCACCACCTT	TCCTCTCACTGC---	GSHHL	S S H C -
GGACAAAGCAGGAGCTCC	GGACAAAGCGGG------	GQSRSS	G Q S G - -
CTGCCAGATGACCAA	CTACTGGATGCC---	MPDDQ	L L D A -
CCTTACCCTCAGCCTCAA	GCTTACCCTCAG------	PYPQPQ	A Y P Q - -
TTGAAGGTGGAGAAA	CTGAAGGAAGAG---	MKVEK	L K E E -
TATGGGGAAGAGTGC	TATGGGGGAGTG---	YGEEC	Y G G V -
GATGGAGAGGAGGAC	GATGGAGATGAG---	DGEED	D G D E -
CCGCAGCCACCGCCGCCACCACCA	CCGCAGGCACCG------------	PQPPPPPP	P Q A P - - - -
ATCACCAGGGATAAG	ATCACCAGCGGT---	ITRDK	I T S G -
TATTTGGAGTGGATAGGTCAGGAC	TACTTCGCCCGG------------	YLEWIGQD	Y F A R - - - -
CTCCCAGAGGCCGGA	CTCCCAGAGGCC---	LPEAG	L P E A -
TCTGAGCTCCTGCTT	TCTGAGCTCCTG---	SELLL	S E L L -
ATCTCAGAAGAAGAGGAGGAAGAG	GTCTCAAAAGAA------------	ISEEEEEE	V S K E - - - -
TCCAGTGAGGAAGAG	TCCAGTGAGGAA---	SSEEE	S S E E -
CAGCGGGAGAAGGAGAAGGAGAAA	CAGAGGGAGAAG------------	QREKEKEK	Q R E K - - - -
CGACGGCATGACCAGCATGAT	CGAAGGCATGAC---------	RRHDQHD	R R H D - - -
GGGGAAGCGGCCGCT	GGGGAAGCGGCC---	GEAAA	G E A A -
GGCTCTGAGGAAGAG	GGCTCTGAGGAA---	GSEEE	G S E E -
AGCTCAGGTGGCGGT	AGCTCCGGTGGC---	SSGGG	S S G G -
GAAGACTTAGAGCTTTGGTCAAAA	AAAGACTCAGAG------------	EDLELWSK	K D S E - - - -
AACTCCAGGCAGCCA	GACTCCATGCTG---	NSRQP	D S M L -
GCTGCAGTAGGGGGCAGCGGCGGT	GCTGCAGGAGGG------------	AAVGGSGG	A A G G - - - -
GACGCCGCGGCGGCGGCC	GACGCCGCGGCG------	DAAAAA	D A A A - -
AACACGCTACCCCAT	GCTACCCCATCC---	NTLPH	A T P S -
TCACCAAGAGGTGCG	TTACCAGGAGGT---	SPRGA	L P G G -
NTGGCCGGGNTCTACANTCGN	TGCCGAGTCTAC---------	XAGXYXR	C R V Y - - -
CTTCGGGGGCCAGAG	CTTCGGGACAGA---	LRGPE	L R D R -
AAGCCCCCGGGTGCGGGTGCGGGC	AAGCCCTCGGGT------------	KPPGAGAG	K P S G - - - -
CAATGTTTGCTTCAA	CACTGTTTGAGT---	QCLLQ	H C L S -
GGAGGCCACAAACAACCTAAC	GGAGGCCCCAAA---------	GGHKQPN	G G P K - - -
ACTTCTGGCAAGAAA	ACTTCTAGCAAG---	TSGKK	T S S K -
GGGGATGCTGCGAATGCTGCA	GGAGATGCTGCG---------	GDAANAA	G D A A - - -
CATCACGGAGAGGAC	CATCATGAAGAG---	HHGED	H H E E -
GAGGAGAAAAAAAAG	GAGGAGAGAAAA---	EEKKK	E E R K -
AGAAGACATTTCTTT	AGAAGATATTTC---	RRHFF	R R Y F -
GTTCCTGGAGGAGGG	GTTCCTGGAGGA---	VPGGG	V P G G -
ACCCTGAAGCACATACAA	AGTCTTTATTCC------	TLKHIQ	S L Y S - -
GCAGAGTCTTCATCT	GCAGAGTCTTCA---	AESSS	A E S S -
GGCTGTGGCAGTGGCGGCGGC	GGCTGTGTCAGT---------	GCGSGGG	G C V S - - -
CATGACAGCAGCAGT	CAGGACAGCAGC---	HDSSS	Q D S S -
TATGAGTACTTTGACAACGTA	TATGAGAACTAT---------	YEYFDNV	Y E N Y - - -
GGAACAGGTGACAAG	GGAACAGATCGC---	GTGDK	G T D R -
AAGAGCGGCGGAGGC	AAGAGCGGCGGA---	KSGGG	K S G G -
GAAGACGAGGAAGAG	GAAGATGAGGAA---	EDEEE	E D E E -
GTGGCTTCCGGCCCCTCA	GTGGCTCCTGAC------	VASGPS	V A P D - -
CAGAACTACTCTTCC	CAGAACTCCTCT---	QNYSS	Q N S S -
CCTCATCTCCCCACT	CTTTATCACGCC---	PHLPT	L Y H A -
GTGGCCCTCCTTCTC	GCGGCCCTCCTT---	VALLL	A A L L -
ACGCAGCCGAGATCAAGG	ACGCAGCAGCGA------	TQPRSR	T Q Q R - -
CTGAAAGATGCAGCG	CTGAAACATTCA---	MKDAA	L K H S -
GGTTTTCCAGGTCCCCCGGGA	GGTTTTCCTGGT---------	GFPGPPG	G F P G - - -
CCTCCCACAACAACCACC	CCTCCCACAACA------	PPTTTT	P P T T - -
CCGGGCCCGCCGCCT	CCGGGCCCGCCG---	PGPPP	P G P P -
AATGACAATATTCCTGTC	TGGTCTATAAGT------	NDNIPV	W S I S - -
ACCGTGCCTCCTCCA	ACCGTGCCTCCT---	TVPPP	T V P P -
CCACAGCCTCCTCCTCCA	CAGCAGCCTCCT------	PQPPPP	Q Q P P - -
TCACCAACGCCTCCG	TCACCACCGCCT---	SPTPP	S P P P -
CTGAGCAAGAAGGAC	CTGGGCAAGAAG---	MSKKD	L G K K -
GAAGAAGCAGCAGCC	AATGAAGCAGCA---	EEAAA	N E A A -
GCTACTTCTTCTTCCTCCTCC	GCTACTTCTTCT---------	ATSSSSS	A T S S - - -
CAGACTTCATGGGAGGCCTCCCTA	CAGACTTCACGG------------	QTSWEASL	Q T S R - - - -
CCCGCGGAGGAAGAG	CCCGCCGAGGAA---	PAEEE	P A E E -
GAAGAGGACGACGAG	GAAGAGGACGAC---	EEDDE	E E D D -
CTCATGAAAAAGAAA	CTCATGAAAAAG---	LMKKK	L M K K -
CTGCCGGAGGAGGAA	CTGCCGGAGGAG---	MPEEE	L P E E -
GAACTCAAGAAGAAA	CAGCTCAAGAAG---	ELKKK	Q L K K -
GAATGGGAGGAAGAG	GAGTGGGAGGAA---	EWEEE	E W E E -
AATGATGGTGAAGAG	AACGATGATGAA---	NDGEE	N D D E -
GGGCCTACTTTGCACCTC	GCACCTCGTTTG------	GPTLHL	A P R L - -
AAAGAGAAGAAAAAG	AAAGAGAAGAAA---	KEKKK	K E K K -
GACCAGGAGGAAGAG	GACCAGGAGGAA---	DQEEE	D Q E E -
CATGTCCTAGGACCCCAG	CATCTTTCAGTA------	HVLGPQ	H L S V - -
GAGCTGGATGGCGAT	GAGCTGGATGCC---	ELDGD	E L D A -
AACGCTCCTCCTCCG	AATGCTCCCCCT---	NAPPP	N A P P -
TCCACAATATCTTCC	GCCACAACATCT---	STISS	A T T S -
GACACCTCTCCACCT	GAGATAACCCCA---	DTSPP	E I T P -
GAGGACGACAGGGATGGT	GAGGACGACAGG------	EDDRDG	E D D R - -
AGCCTGCCTTCATCC	GGCCTGACTTCA---	SLPSS	G L T S -
ATGGAAAATGGGAGGACCAATGGC	AAGGAAAATGGG------------	MENGRTNG	K E N G - - - -
GTGCTGTGCAAGAAA	GTGCTGAGCAAG---	VLCKK	V L S K -
CTCCACAAAAATTCC	CTCCACAAAAAT---	LHKNS	L H K N -
ACAGGTGAAAACGACGATGAAAAT	ACAGGCGAAGGC------------	TGENDDEN	T G E G - - - -
ATCTTGGCTGCAGCT	ATCTTGGCTGCA---	ILAAA	I L A A -
GATGTGACTAGCAAT	GATGTGCCTGGC---	DVTSN	D V P G -
AGGCAGTTGCTCTTA	AGGACGTTCCTC---	RQLLL	R T F L -
ATCTCCACAGCTGCA	ATCTCTGCAGCT---	ISTAA	I S A A -
CAGGTCCCAGCTGGCCATAGCCAG	CAGGTCTCGTCT------------	QVPAGHSQ	Q V S S - - - -
GACACACCTTCATCC	GACACATCTGCA---	DTPSS	D T S A -
CCTGCATCCAGCAGT	CCTGCATCCAGC---	PASSS	P A S S -
