wid.1	wid.2	amino_acid.1	amino_acid.2
CTGCCGCTCCTGAGGCCT	CTGGCA------ACCCGG	MPLLRP	L A - - T R
GAGCACCAGGAGGAA	GAACAC---CAGGAG	EHQEE	E H - Q E
AGGGGACCTGGGGGT	AGGGGG---TCTGGG	RGPGG	R G - S G
ACTTCAACACCCACTCCAACTCCA	ACTTCA------------ATACCC	TSTPTPTP	T S - - - - I P
CCTTATTCTTCCTCTTCTTCCTCT	CCTTAT------------TCTTCC	PYSSSSSS	P Y - - - - S S
TGCTCCAATATCACTCAG	TGCTCC------AGCTCC	CSNITQ	C S - - S S
ATGTTTGGTGGGAAA	ATGTTA---GGCCGG	MFGGK	M L - G R
TCACAAGTAAGCTGGGATCAATCT	TCACAA------------GAAAGC	SQVSWDQS	S Q - - - - E S
TGTGGACTTGAAGAC	TGTGAA---CATGGA	CGLED	C E - H G
GGAGAAGAAGCCGAAGCA	GGAGAA------GAAGCC	GEEAEA	G E - - E A
GACGACGAGGAGGAA	GACGAC---GAGGAG	DDEEE	D D - E E
GTTGGCGTGCTTTTC	CATGGT---TGGCGT	VGVLF	H G - W R
ATGAATGAAAAGGATGAGAAA	ATGAAT---------GAAAAG	MNEKDEK	M N - - - E K
ACCAGGGCTGCTGCC	ACCAGG---ACTGCT	TRAAA	T R - T A
ACAGAAGGCCCGGCA	GGGGAA---GTCCTG	TEGPA	G E - V L
GTGGAGGGTGAAGGAATTGTTACT	GAGAAG------------GCTGGA	VEGEGIVT	E K - - - - A G
GAGAAGGAAGAAGAG	GAGAAG---GAGGAA	EKEEE	E K - E E
GGCTGCGGCGGCGGT	GGCTGC---GGCAGC	GCGGG	G C - G S
GCCCTCGACGATGCA	GCCCTT---GACGTT	ALDDA	A L - D V
GCGGCCGTGGAGGTTTCT	GCGGCG------GTGGTG	AAVEVS	A A - - V V
GATGAGCCGGCCACACCGCCCTCT	AACGAG------------CAAGGC	DEPATPPS	N E - - - - Q G
GCCCAGTCCTCTTCCTCC	GCCCAG------ACCTCT	AQSSSS	A Q - - T S
ATAAGTTTAGGGGAC	AAAAGT---AAAAGG	ISLGD	K S - K R
CGTTCCTCCAGAAGCCGC	CGTTCC------TCCAGA	RSSRSR	R S - - S R
TCCCACCCAGAGCGC	TCCTAC---CAAGAG	SHPER	S Y - Q E
TCTGCCACCACCACCACTACT	TCTGCC---------ACCACC	SATTTTT	S A - - - T T
CCCCCAAGCAGCAGT	CCCCCG---AGCAGC	PPSSS	P P - S S
CAGTCCACCACCACT	CAGTCC---ACCACC	QSTTT	Q S - T T
CCCACTCCTCCACCGCCT	CCTACT------CCTCCA	PTPPPP	P T - - P P
GTAGAGCGGTCACTCACC	GCAGAG------CAGTCA	VERSLT	A E - - Q S
AAGACTTTCCATTTCCAC	AAGTCT------TTCCAT	KTFHFH	K S - - F H
GCGTTGCCGCCGCCA	GCGTTG---CCACCG	ALPPP	A L - P P
CCTGCCACAGCCGCTACCCCAACT	CCTGCC------------CCAGCC	PATAATPT	P A - - - - P A
CACCTTGATGATGAC	CACCTT---GATGAT	HLDDD	H L - D D
CAGCCGGCGGCGGCA	CAGCCA---GCGGCG	QPAAA	Q P - A A
AAATTTCCAATCGAGACGCCA	TATTTT---------TCCTAC	KFPIETP	Y F - - - S Y
AGCTTCGGGGAGGAA	AGCTTC---AGGGAG	SFGEE	S F - R E
GCAGGAGAGGAAGAG	GCAGGA---GAGGAA	AGEEE	A G - E E
CATGGCTCCAGCTCTTCT	CATGGC------TCCAGC	HGSSSS	H G - - S S
GAGGCAATAGGGTCGGGA	GAGGCA------ACAGGG	EAIGSG	E A - - T G
CAGGCTGTGATGAGT	CAGGCT---GATGAG	QAVMS	Q A - D E
AAATCTAAGAAGAAA	AAACCT---AAGAAG	KSKKK	K P - K K
ACTACCCCAGGGACTGTGCCAGCA	ACACAC------------CTCCAG	TTPGTVPA	T H - - - - L Q
GAACCTACTACTACA	GAACCT---ACCACT	EPTTT	E P - T T
AAGGATTTGTGCTCT	AGGGGT---GCCAGC	KDLCS	R G - A S
CAGCTGCAGCAGCAGCAGCAA	CAGTTG---------CAGCAG	QLQQQQQ	Q L - - - Q Q
CCCGTGTTCCCTTGC	CCCGTT---TCCCTT	PVFPC	P V - S L
GGATTGCCAACTCAA	GGATTG---ACAGCT	GLPTQ	G L - T A
ACGCAGCCCTCGCTGCCCTCT	ACGCAG---------CCCTCG	TQPSLPS	T Q - - - P S
AAACCTCTTGAGTGCGGC	GGGACT------CTGGTG	KPLECG	G T - - L V
CGCAGCGCGGCGGCC	CACTCC---CTTGAG	RSAAA	H S - L E
TTAGCCCCCCCACCG	GTAGCT---CCCCCA	LAPPP	V A - P P
ACTCCAAAGAAGAAA	ATTCCA---AAGAAG	TPKKK	I P - K K
CCTCCCGAGGAAGAGGAG	CCTCCC------GAGGAA	PPEEEE	P P - - E E
ACCGGGACCCAGGAGGCGACCCAA	ACCGGG------------ACCCAG	TGTQEATQ	T G - - - - T Q
TCTTCCCTGCCTCCA	TCTTCC---CAGCCT	SSLPP	S S - Q P
CAGCAGCCGCCGCCA	CCGCAG---CCACCG	QQPPP	P Q - P P
CACACACCGCCGCCC	CACTCA---CCACCG	HTPPP	H S - P P
TGCTGGAACCTGTCTCTA	TGCTGG------AGCCTG	CWNLSL	C W - - S L
GGTAGTGGCGGTGGC	GGTAGT---GGCGGT	GSGGG	G S - G G
AATGCAGGCACAGGCTCG	AATGCA------GGCACA	NAGTGS	N A - - G T
GAACAGGAGGAGGAGGAGGAA	GAACAG---------GAGGAG	EQEEEEE	E Q - - - E E
GAGGAGGAAGAGGAAAATGAGGAA	GAGGAA------------GAAGAG	EEEEENEE	E E - - - - E E
AAACGTAAACTTAGC	AAGCAT---GAACAT	KRKLS	K H - E H
GCAGAGGAGGAAGATGAAGAG	GCAGAG---------GAGGAA	AEEEDEE	A E - - - E E
GAGCAAGACGACGAT	GAGCAA---GATGAC	EQDDD	E Q - D D
CCAGGGCTACTTCTA	CCAGGG---CTCCTT	PGLLL	P G - L L
CCTGAAGCAGCCCGT	CGTGAA---GCAGCC	PEAAR	R E - A A
AAAGATGGGCCGGGAAAGGCT	AAAGAT---------GAGCTG	KDGPGKA	K D - - - E L
GGTGCCGAAAGCAGA	AATGTG---GCTAAC	GAESR	N V - A N
CCTGATGAAGAAGAG	CCTGAT---GAAGAA	PDEEE	P D - E E
GAAGGAGATGAAGAG	GAAGGA---GATGAA	EGDEE	E G - D E
AAACAAGAAGAAGAG	AAACAA---GAAAAA	KQEEE	K Q - E K
CGAGCTGGAGGCGGG	CGAGCT---GGAGGC	RAGGG	R A - G G
CACGAGAGCAGCAGT	CGCGAG---TGCAGC	HESSS	R E - C S
GAGCTGGAAGAGGAA	GAGCTG---GAAGAG	ELEEE	E L - E E
GCACCACAGGAAGAG	GCACCA---CAGGAA	APQEE	A P - Q E
ACACATAGAGATAGAGAC	ACACAC------AGAGAT	THRDRD	T H - - R D
CTGAGCGCAGCGGCC	CTGAGC---GCAGCG	MSAAA	L S - A A
CCTCACACAGCCAGCCCTCCAGCA	CCCCAC------------ACAGCC	PHTASPPA	P H - - - - T A
GAGACAGAGGAAGAG	GAGACA---GAGGAA	ETEEE	E T - E E
TACGACATCGCTAAC	TATGAC---AACACT	YDIAN	Y D - N T
GGCGGCGGCGGCGCGGGCGGA	GGCGGC---------GCGGGC	GGGGAGG	G G - - - A G
CCAAACACGCCAACCACG	CCAAAC------GCATCA	PNTPTT	P N - - A S
AGCGGTGCCAGCGCCAGT	AGCGGT------GCTAGC	SGASAS	S G - - A S
AGCAAAGAGGAAGAG	AGCAAA---GAGGAA	SKEEE	S K - E E
GAGAAGGAAGAGGAA	GAGAAG---GAAGAG	EKEEE	E K - E E
GGTGACGGCGGCGGG	GGCGAT---GGCGGC	GDGGG	G D - G G
GTGGGGGATGACGAT	GTGGGG---GATGAC	VGDDD	V G - D D
GAAAATGTATCTGCG	GCAGAG---GACAGT	ENVSA	A E - D S
GAGGGAGAGGAAGAG	GAGGGA---GAGGAA	EGEEE	E G - E E
GAAGGGGAGGAGGAA	GAAGGG---GAGGAG	EGEEE	E G - E E
CCGGCTCCACCTCCACCC	CCGGCC------CCACCT	PAPPPP	P A - - P P
AAGTCACTACCACTGCAG	GAGTCC------CTGGCA	KSLPLQ	E S - - L A
TACTACGCCGCGGCA	ACCTAC---GCCGCG	YYAAA	T Y - A A
GCAGGGGCGGCGGCGGCA	GCGGGG------GCAGCG	AGAAAA	A G - - A A
GACTACGGAGGTGGA	GAGTAC---GGCGGT	DYGGG	E Y - G G
GAAGACAACAAGGAGAACAAA	GAAGAC---------AACAAG	EDNKENK	E D - - - N K
TCCCAGTCAGGGTCAGGA	TCACAG------TCAGGG	SQSGSG	S Q - - S G
GCATCCACCACCACT	GCATCT---ACCACC	ASTTT	A S - T T
CACCCGGAAGAGGAA	CACCCG---GAAGAG	HPEEE	H P - E E
GCGGAAGAGGACGAGGAT	GCCGAG------GAGGAC	AEEDED	A E - - E D
GTTATTCCACCTCCC	GTTATT---CCACCT	VIPPP	V I - P P
GATGAAGAGGATGAGGAC	GATGAG------GAGGAT	DEEDED	D E - - E D
GCCGCTGAGGACGAT	GCCACC---GAGGAC	AAEDD	A T - E D
TCCACCCCGCCCCCGCCCCCGCCG	TCCACC------------CCTCCC	STPPPPPP	S T - - - - P P
CCCGGCGTGCCGTCC	CGTGAC---CGTCTG	PGVPS	R D - R L
GGAAACAGCCCTCCAGCCAGTGAG	GGAAAC------------AGCTCT	GNSPPASE	G N - - - - S S
GGATCCGGGGGAGGC	GGATCT---GGGGGA	GSGGG	G S - G G
CTGCTGGCTGCTGCC	CTTCTG---GCTGCT	MLAAA	L L - A A
GAGGATGAAGACACA	GAGGAC---GAAGAC	EDEDT	E D - E D
AAAGAGAAAAAGAAA	AAAGAG---AAAAAG	KEKKK	K E - K K
CCATATGCTCAGGCTCAA	CCATAT------GCCCAG	PYAQAQ	P Y - - A Q
TTTTCAGAAGTAGCACGC	TTCGGA------ATAGCA	FSEVAR	F G - - I A
CACCAAGGCTCTAGGAAGCAG	CACAAA---------CGCTCT	HQGSRKQ	H K - - - R S
CACTTCTTGTTGTTA	CACTTC---TTGTTG	HFLLL	H F - L L
CGGGGAATCCGAAGTCGG	GGGGGA------AGCCGA	RGIRSR	G G - - S R
AGTCCTTGCGGTCAGAAG	AGTCCT------TACCGT	SPCGQK	S P - - Y R
CTGAAGGCGGGAACC	CTGGAG---GCAGGA	MKAGT	L E - A G
GCGACCGCGGCGGCC	GCGACC---GCGGCG	ATAAA	A T - A A
AGCGCGCAGCAGCAA	AGCGCG---CAGCAG	SAQQQ	S A - Q Q
AAGGTGAGGACTGTG	AAGATC---GTGGCT	KVRTV	K I - V A
AAACATTGTGACCAA	AAGTAC---GGAGTC	KHCDQ	K Y - G V
TTTGGGACAAAATAC	TTTGGG---AGGCAA	FGTKY	F G - R Q
GAAGACGAGGACGAT	GAAGAC---GAGGAC	EDEDD	E D - E D
TCAGGTGCTGGAAGT	TCAGGT---GGTGGA	SGAGS	S G - G G
CCAGGCAGCAGCAGT	CCAGGC---AGCAGC	PGSSS	P G - S S
TCTGTACTGACAAAG	TCTGAA---GTGACA	SVLTK	S E - V T
CGCAGCGGTCTGCTA	CGCAGC---CGCCTG	RSGLL	R S - R L
CAGCGGCAGCAGCAA	CAGCGG---CAGCAG	QRQQQ	Q R - Q Q
CCCCGCGGCGGCGGCGGCGGCGGT	CCCCGC------------GGCGGC	PRGGGGGG	P R - - - - G G
TACCAGGAAGAGGAA	TACCAG---GAAGAG	YQEEE	Y Q - E E
CAAGGAACCCCCGGGGCT	CAAGGA------GCCCTC	QGTPGA	Q G - - A L
CACAGTGACCATGATGACCAC	CACAGT---------GACCAT	HSDHDDH	H S - - - D H
ATTTACCCCCTGTTGCTGCTA	GTCTAC---------CTCCTG	IYPLLLL	V Y - - - L L
GAGAATCGTGAGTGGGTTCGTGCT	GAGAAT------------CTCCTG	ENREWVRA	E N - - - - L L
GGCTCCGCCGCTGCCGCC	GGCTCC------GCCGCT	GSAAAA	G S - - A A
CTCAAGGATGCTCGTTCG	TTACAA------AAGGTT	LKDARS	L Q - - K V
GGACAGGCTGATGCTGACGCTGAC	GAGCAG------------GCTGAT	GQADADAD	E Q - - - - A D
GCACAGGTGCGGTCC	TCTCAG---GAAGGG	AQVRS	S Q - E G
AGACAGAGTGTGGATTCT	GAAAAA------CAAGAG	RQSVDS	E K - - Q E
GGGAAAGCAGCTGCA	GGGACA---GCAGCT	GKAAA	G T - A A
CTCCTCATCCTTCTC	CTCTTC---ATCCTT	LLILL	L F - I L
GGGGCGCCACTTGTACATGAGATC	AGTTCC------------CAATCT	GAPLVHEI	S S - - - - Q S
TCAAGAGAGGAAGAG	TCAAGA---GAGGAA	SREEE	S R - E E
GGTTCAGGGTCACCT	GGTTCA---GGGTCA	GSGSP	G S - G S
GAGGCGAAGGTCAAGGTG	GAGTCG------AAGGTC	EAKVKV	E S - - K V
GCCATCACTTCAAAAGACAATAAC	GCTGTC------------AATTCA	AITSKDNN	A V - - - - N S
GAAGGAACACTAACACTG	GAAAGA------ACGCTA	EGTLTL	E R - - T L
GCTACTGCTGCTGCC	GCTACT---GCTGCT	ATAAA	A T - A A
CATCACCAGCAACAG	CACCAC---CACCAA	HHQQQ	H H - H Q
TCGGACTCCAGCTCG	TCAGAC---TCCAGC	SDSSS	S D - S S
AAAGACAAGGGCAGGGGCAAGGGT	AAAGAG------------AAGGGC	KDKGRGKG	K E - - - - K G
AAAAAAGATGCAACG	AAGAAA---GGCTTA	KKDAT	K K - G L
TCCATCTCCTCGTCCTCC	TCCATC------TCCTCG	SISSSS	S I - - S S
GAACACGAGGAGGAA	GGGCAC---GAGGAG	EHEEE	G H - E E
GATTGCAGCAGCAGT	GATCAC---AGCGGC	DCSSS	D H - S G
ATGATGTCCAGTTCA	ATGGTG---TCCAGT	MMSSS	M V - S S
CATCGACAGCAGCAGCAA	CATCGA------CAGCAG	HRQQQQ	H R - - Q Q
CACCCGGAAGAGGAA	CACCCG---GAAGAG	HPEEE	H P - E E
GGCATTGTGGCCAAG	AACCTT---GGAGGC	GIVAK	N L - G G
GACAGTTACAACCGCCTCAAGAGT	GACGGG------------CGCCCC	DSYNRLKS	D G - - - - R P
TCTGGCCTAGCACAAATTGAG	GCTGAC---------CTGGCA	SGLAQIE	A D - - - L A
GAGGAGGCGGCGGCA	GAGGAG---GCTGTG	EEAAA	E E - A V
GGCAGCCACCACCTT	TCCTCT---CACTGC	GSHHL	S S - H C
GGACAAAGCAGGAGCTCC	GGACAA------AGCGGG	GQSRSS	G Q - - S G
CTGCCAGATGACCAA	CTACTG---GATGCC	MPDDQ	L L - D A
CCTTACCCTCAGCCTCAA	GCTTAC------CCTCAG	PYPQPQ	A Y - - P Q
TTGAAGGTGGAGAAA	CTGAAG---GAAGAG	MKVEK	L K - E E
TATGGGGAAGAGTGC	TATGGG---GGAGTG	YGEEC	Y G - G V
GATGGAGAGGAGGAC	GATGGA---GATGAG	DGEED	D G - D E
CCGCAGCCACCGCCGCCACCACCA	CCGCAG------------GCACCG	PQPPPPPP	P Q - - - - A P
ATCACCAGGGATAAG	ATCACC---AGCGGT	ITRDK	I T - S G
TATTTGGAGTGGATAGGTCAGGAC	TACTTC------------GCCCGG	YLEWIGQD	Y F - - - - A R
CTCCCAGAGGCCGGA	CTCCCA---GAGGCC	LPEAG	L P - E A
TCTGAGCTCCTGCTT	TCTGAG---CTCCTG	SELLL	S E - L L
ATCTCAGAAGAAGAGGAGGAAGAG	GTCTCA------------AAAGAA	ISEEEEEE	V S - - - - K E
TCCAGTGAGGAAGAG	TCCAGT---GAGGAA	SSEEE	S S - E E
CAGCGGGAGAAGGAGAAGGAGAAA	CAGAGG------------GAGAAG	QREKEKEK	Q R - - - - E K
CGACGGCATGACCAGCATGAT	CGAAGG---------CATGAC	RRHDQHD	R R - - - H D
GGGGAAGCGGCCGCT	GGGGAA---GCGGCC	GEAAA	G E - A A
GGCTCTGAGGAAGAG	GGCTCT---GAGGAA	GSEEE	G S - E E
AGCTCAGGTGGCGGT	AGCTCC---GGTGGC	SSGGG	S S - G G
GAAGACTTAGAGCTTTGGTCAAAA	AAAGAC------------TCAGAG	EDLELWSK	K D - - - - S E
AACTCCAGGCAGCCA	GACTCC---ATGCTG	NSRQP	D S - M L
GCTGCAGTAGGGGGCAGCGGCGGT	GCTGCA------------GGAGGG	AAVGGSGG	A A - - - - G G
GACGCCGCGGCGGCGGCC	GACGCC------GCGGCG	DAAAAA	D A - - A A
AACACGCTACCCCAT	GCTACC---CCATCC	NTLPH	A T - P S
TCACCAAGAGGTGCG	TTACCA---GGAGGT	SPRGA	L P - G G
NTGGCCGGGNTCTACANTCGN	TGCCGA---------GTCTAC	XAGXYXR	C R - - - V Y
CTTCGGGGGCCAGAG	CTTCGG---GACAGA	LRGPE	L R - D R
AAGCCCCCGGGTGCGGGTGCGGGC	AAGCCC------------TCGGGT	KPPGAGAG	K P - - - - S G
CAATGTTTGCTTCAA	CACTGT---TTGAGT	QCLLQ	H C - L S
GGAGGCCACAAACAACCTAAC	GGAGGC---------CCCAAA	GGHKQPN	G G - - - P K
ACTTCTGGCAAGAAA	ACTTCT---AGCAAG	TSGKK	T S - S K
GGGGATGCTGCGAATGCTGCA	GGAGAT---------GCTGCG	GDAANAA	G D - - - A A
CATCACGGAGAGGAC	CATCAT---GAAGAG	HHGED	H H - E E
GAGGAGAAAAAAAAG	GAGGAG---AGAAAA	EEKKK	E E - R K
AGAAGACATTTCTTT	AGAAGA---TATTTC	RRHFF	R R - Y F
GTTCCTGGAGGAGGG	GTTCCT---GGAGGA	VPGGG	V P - G G
ACCCTGAAGCACATACAA	AGTCTT------TATTCC	TLKHIQ	S L - - Y S
GCAGAGTCTTCATCT	GCAGAG---TCTTCA	AESSS	A E - S S
GGCTGTGGCAGTGGCGGCGGC	GGCTGT---------GTCAGT	GCGSGGG	G C - - - V S
CATGACAGCAGCAGT	CAGGAC---AGCAGC	HDSSS	Q D - S S
TATGAGTACTTTGACAACGTA	TATGAG---------AACTAT	YEYFDNV	Y E - - - N Y
GGAACAGGTGACAAG	GGAACA---GATCGC	GTGDK	G T - D R
AAGAGCGGCGGAGGC	AAGAGC---GGCGGA	KSGGG	K S - G G
GAAGACGAGGAAGAG	GAAGAT---GAGGAA	EDEEE	E D - E E
GTGGCTTCCGGCCCCTCA	GTGGCT------CCTGAC	VASGPS	V A - - P D
CAGAACTACTCTTCC	CAGAAC---TCCTCT	QNYSS	Q N - S S
CCTCATCTCCCCACT	CTTTAT---CACGCC	PHLPT	L Y - H A
GTGGCCCTCCTTCTC	GCGGCC---CTCCTT	VALLL	A A - L L
ACGCAGCCGAGATCAAGG	ACGCAG------CAGCGA	TQPRSR	T Q - - Q R
CTGAAAGATGCAGCG	CTGAAA---CATTCA	MKDAA	L K - H S
GGTTTTCCAGGTCCCCCGGGA	GGTTTT---------CCTGGT	GFPGPPG	G F - - - P G
CCTCCCACAACAACCACC	CCTCCC------ACAACA	PPTTTT	P P - - T T
CCGGGCCCGCCGCCT	CCGGGC---CCGCCG	PGPPP	P G - P P
AATGACAATATTCCTGTC	TGGTCT------ATAAGT	NDNIPV	W S - - I S
ACCGTGCCTCCTCCA	ACCGTG---CCTCCT	TVPPP	T V - P P
CCACAGCCTCCTCCTCCA	CAGCAG------CCTCCT	PQPPPP	Q Q - - P P
TCACCAACGCCTCCG	TCACCA---CCGCCT	SPTPP	S P - P P
CTGAGCAAGAAGGAC	CTGGGC---AAGAAG	MSKKD	L G - K K
GAAGAAGCAGCAGCC	AATGAA---GCAGCA	EEAAA	N E - A A
GCTACTTCTTCTTCCTCCTCC	GCTACT---------TCTTCT	ATSSSSS	A T - - - S S
CAGACTTCATGGGAGGCCTCCCTA	CAGACT------------TCACGG	QTSWEASL	Q T - - - - S R
CCCGCGGAGGAAGAG	CCCGCC---GAGGAA	PAEEE	P A - E E
GAAGAGGACGACGAG	GAAGAG---GACGAC	EEDDE	E E - D D
CTCATGAAAAAGAAA	CTCATG---AAAAAG	LMKKK	L M - K K
CTGCCGGAGGAGGAA	CTGCCG---GAGGAG	MPEEE	L P - E E
GAACTCAAGAAGAAA	CAGCTC---AAGAAG	ELKKK	Q L - K K
GAATGGGAGGAAGAG	GAGTGG---GAGGAA	EWEEE	E W - E E
AATGATGGTGAAGAG	AACGAT---GATGAA	NDGEE	N D - D E
GGGCCTACTTTGCACCTC	GCACCT------CGTTTG	GPTLHL	A P - - R L
AAAGAGAAGAAAAAG	AAAGAG---AAGAAA	KEKKK	K E - K K
GACCAGGAGGAAGAG	GACCAG---GAGGAA	DQEEE	D Q - E E
CATGTCCTAGGACCCCAG	CATCTT------TCAGTA	HVLGPQ	H L - - S V
GAGCTGGATGGCGAT	GAGCTG---GATGCC	ELDGD	E L - D A
AACGCTCCTCCTCCG	AATGCT---CCCCCT	NAPPP	N A - P P
TCCACAATATCTTCC	GCCACA---ACATCT	STISS	A T - T S
GACACCTCTCCACCT	GAGATA---ACCCCA	DTSPP	E I - T P
GAGGACGACAGGGATGGT	GAGGAC------GACAGG	EDDRDG	E D - - D R
AGCCTGCCTTCATCC	GGCCTG---ACTTCA	SLPSS	G L - T S
ATGGAAAATGGGAGGACCAATGGC	AAGGAA------------AATGGG	MENGRTNG	K E - - - - N G
GTGCTGTGCAAGAAA	GTGCTG---AGCAAG	VLCKK	V L - S K
CTCCACAAAAATTCC	CTCCAC---AAAAAT	LHKNS	L H - K N
ACAGGTGAAAACGACGATGAAAAT	ACAGGC------------GAAGGC	TGENDDEN	T G - - - - E G
ATCTTGGCTGCAGCT	ATCTTG---GCTGCA	ILAAA	I L - A A
GATGTGACTAGCAAT	GATGTG---CCTGGC	DVTSN	D V - P G
AGGCAGTTGCTCTTA	AGGACG---TTCCTC	RQLLL	R T - F L
ATCTCCACAGCTGCA	ATCTCT---GCAGCT	ISTAA	I S - A A
CAGGTCCCAGCTGGCCATAGCCAG	CAGGTC------------TCGTCT	QVPAGHSQ	Q V - - - - S S
GACACACCTTCATCC	GACACA---TCTGCA	DTPSS	D T - S A
CCTGCATCCAGCAGT	CCTGCA---TCCAGC	PASSS	P A - S S
