wid.1	wid.2	amino_acid.1	amino_acid.2
AGAATGGGAATACAGAAA	------GAAAAACAGGAC	RMGIQK	- - E K Q D
ATGGAAGTTGGGGCC	---GGAAGTCGGGCC	MEVGA	- G S R A
CTGATAAAGGAGTCT	---ACACTGGAGTCT	MIKES	- T L E S
AGCTCAGTCGCAGAT	---TCAGTAGCAGAT	SSVAD	- S V A D
CACAGTGATCCATCT	---AGTGCTCCGTCT	HSDPS	- S A P S
CCTGGGGAGCTCTCAGCCTCCAGG	------------TCAGGCTTCAGG	PGELSASR	- - - - S G F R
GTAAGCATTGGTGAGAAA	------ATTGTTGAAGAA	VSIGEK	- - I V E E
AACCACACTTTAGAA	---CACGTTTTAGAA	NHTLE	- H V L E
TCTGCGGGAACCAGCGAC	------GAACCCACCAGC	SAGTSD	- - E P T S
AGCCAAAGTTTTGTC	---CCAAAGTTTGTT	SQSFV	- P K F V
CTCTCTGGCAGCAGGAACAGCAGA	------------AGCAGCAGCAGA	LSGSRNSR	- - - - S S S R
ACATCTTTCCAGACT	---TCTTCCCAGACT	TSFQT	- S S Q T
GACAACACTGAAGAA	---AATGCTGAAGAA	DNTEE	- N A E E
ACACCCTACCATTTTACT	------TACCCTTTTACT	TPYHFT	- - Y P F T
TTGAAGTTGGCGCGT	---ACAGGGAAGCGG	MKLAR	- T G K R
AGGTTACAATCCGGT	---TCCCTTTCAGGT	RLQSG	- S L S G
CCCTCCATCAAGGCT	---TACCGCAAGGCT	PSIKA	- Y R K A
GAAAGTACAATTCTC	---AGAGACGTTCTC	ESTIL	- R D V L
CACAGATTACAATGG	---ACAGATACAATG	HRLQW	- T D T M
TCCACTGCTGCCACC	---ATTGTCTGCAAG	STAAT	- I V C K
ACACAGGAGTTCTGGACC	------GAGTCCCGGACC	TQEFWT	- - E S R T
AAGCTGGACACGGAA	---CCGGCCGCGGAA	KLDTE	- P A A E
ACTGCTGCTCCCACT	---GCTGCTCCCACT	TAAPT	- A A P T
CAGAATATCGAGAAG	---AGAACACAGAAG	QNIEK	- R T Q K
CATTTTGATCAGAATGTT	------GTGCTGGCTGTG	HFDQNV	- - V L A V
GCTAGTACGTATGCT	---ATTAAACATGCC	ASTYA	- I K H A
AATGCTCTTTCTGTAACCAGT	---------TCTGCGACCAGT	NALSVTS	- - - S A T S
TCCATACCATCAGAT	---AAAGTTTCAGAT	SIPSD	- K V S D
ACTGACAGTCATACA	---GGCAACCATACA	TDSHT	- G N H T
AGTGAGGGGGAGCAT	---GCGAGGGAGCAC	SEGEH	- A R E H
ACTATTACAGATGTGGAAGCTGTT	------------GTGATCGCTGCT	TITDVEAV	- - - - V I A A
AGCATAGGCTCTCCAGGC	------GACTTTCCAGAC	SIGSPG	- - D F P D
GCCCCGCCCCCCACA	---CCGCCCCCCACA	APPPT	- P P P T
CCGGACTCGACGGCGAGG	------TCGACGACGATG	PDSTAR	- - S T T M
CTTTTACCTGACACA	---TTACTTGACACA	LLPDT	- L L D T
AGTGAGTGGGAGAGA	---GAGCAGTTGAGG	SEWER	- E Q L R
CAGAACCCCTTCAAC	---ATCTCCTTCAAC	QNPFN	- I S F N
GCGGCACTGACAGGCTTT	------CTGCCAGGCTTT	AALTGF	- - L P G F
ATAGAAGTACTTTCA	---GCGAGACTCGCA	IEVLS	- A R L A
TCGGAGAAGTTGGAACAGCAAGAT	------------GATGAGGACGAT	SEKLEQQD	- - - - D E D D
AAGTCCAGGGATGTG	---TCCACGGATACA	KSRDV	- S T D T
AGCGCCTGCCTTCAGGGC	------TCAAGGAAACAG	SACLQG	- - S R K Q
ACGCTGTTTGTTCAA	---CGCTGTGTCCAA	TLFVQ	- R C V Q
CCTGAAGTGATTCTA	---GAAGAGATTCTA	PEVIL	- E E I L
TTGATGATTGACCCG	---ATTCTTGACCCG	MMIDP	- I L D P
TCCCAGCCGCCTTCA	---CAGCAGCCTTCA	SQPPS	- Q Q P S
GCCCCCACCAACCCCCAGGCT	---------AGCCCCGAGGCA	APTNPQA	- - - S P E A
TCTAACCCTGGGATT	---ATACAGAACTTA	SNPGI	- I Q N L
GAAAGTGCAAAGGTG	---ATCTCAACAATG	ESAKV	- I S T M
AGTTCCAACCAAAAA	---TCAAGCCAAAAA	SSNQK	- S S Q K
GAGGAACTGAGGCCAGAGCAT	---------AGGCCAGAGCGG	EELRPEH	- - - R P E R
ACGCTCATCCCGTTG	---CTCCACCTACTG	TLIPL	- L H L L
GCGCAGCAGCAGCCTTCC	------CAGCAGGCTTCT	AQQQPS	- - Q Q A S
TCCAGTACCACAGAG	---AATAACACCGAG	SSTTE	- N N T E
TGCGAGGGTCCCATC	---GCGAGGCCCATC	CEGPI	- A R P I
CCCCTCGGGGTGGGCGGGGCT	---------GAAGAACCGTCA	PLGVGGA	- - - E E P S
TCTTTAAATCTGGTCAGT	------AGCCTGGCAGTC	SLNLVS	- - S L A V
GGCAGCCCCAACAGG	---AGCTCCAGCAGG	GSPNR	- S S S R
TCCACAGCAGCGTCCAACTCC	---------GGGCCCAGTTCC	STAASNS	- - - G P S S
AGCTCTGGCAGGAAC	---TCTGACAGGAAC	SSGRN	- S D R N
GCGACATCATCAGGCAGC	------TCATCAGGCAGC	ATSSGS	- - S S G S
GAAGTATTAAGAGATCCAATT	---------AGCATTGCAATC	EVLRDPI	- - - S I A I
AACTCCCCGCTCTGCTGCCCTGAA	------------TCAGACCCTGAA	NSPLCCPE	- - - - S D P E
AGCTCTGGGGACTTG	---TCTGAGGACTTA	SSGDL	- S E D L
GGGTTCTGGACAGGT	---TCCCCAAGCCGT	GFWTG	- S P S R
CCTGGTGAGCAGGAGGAACTGCGG	------------GGAGCATTGAAG	PGEQEELR	- - - - G A L K
GATCACTGTGTGCTG	---CCCTATGTGCTA	DHCVL	- P Y V L
AGTGGTCTACCAAGC	---GAACCACCACCC	SGLPS	- E P P P
TCCACCACCTCCTCC	---ACCACCTCCTCG	STTSS	- T T S S
GACATAGGCAAGGTG	---ATGGTTGAAGTA	DIGKV	- M V E V
TCAGCCTTGGAAAGA	---GCCTCGGAGAGA	SALER	- A S E R
AGCGACCCCCACAAGGGA	------CACAACAGGAGA	SDPHKG	- - H N R R
GAAAGAAGTTTCAGG	---AGGAAGTTTCAG	ERSFR	- R K F Q
GCCACGGAGACCAAC	---AATCTGATGGGT	ATETN	- N L M G
TCGAGCCCCCAGGGA	---AGTTCCCAGGGG	SSPQG	- S S Q G
TATGTTTTTAGGACC	---GGCTCTCGGAGC	YVFRT	- G S R S
AAACACAGGGAGAGTCCAAGG	---------GAGAATCCGAGA	KHRESPR	- - - E N P R
AAAGAAGAGATTGCA	---GAAGAGACTGCA	KEEIA	- E E T A
ACACTGCTGCAGGAGCCT	------CTGCTAGAGTCT	TLLQEP	- - L L E S
GCCCCACACCTCTCAGAA	------CACCCCTCAGAA	APHLSE	- - H P S E
TCCAAGTTCAGTAATGATGAC	---------AGCCGTGATGAC	SKFSNDD	- - - S R D D
TCCAGATACCTGTAC	---ATGGAGGTTTTC	SRYLY	- M E V F
CAAAAGTCTGATGGTTCT	------TCTAAGGGTTCT	QKSDGS	- - S K G S
AATGTGGACTACGCC	---GCAGCCCACACT	NVDYA	- A A H T
GGCGTGGGAAGCCTGGGAAGC	---------ATCATGGGAAGC	GVGSLGS	- - - I M G S
CACCAGGCAGCTGCGGCT	------GCAGCTGCAGCT	HQAAAA	- - A A A A
TTCAAAATGAACCATAAA	------AAGAAGCAGAAG	FKMNHK	- - K K Q K
GAAGAGGAAACAGGGAAGTCA	---------ACAGAAAAGTCA	EEETGKS	- - - T E K S
