wid.1	wid.2	amino_acid.1	amino_acid.2
GCCTCGGCTACAGAG	TTGACT---ACAGAG	ASATE	L T - T E
AGAATGGGAATACAGAAA	GAAAAA------CAGGAC	RMGIQK	E K - - Q D
TTGCTGCTGTGGTCC	CTGCTG---TGGTCC	MLLWS	L L - W S
GCTCGGTACAGCTCAGCA	TTCCGC------TCAGCA	ARYSSA	F R - - S A
ATGGAAGTTGGGGCC	GGAAGT---CGGGCC	MEVGA	G S - R A
AAGCTCCTTTGGCTG	CGCCTA---TGGTTG	KLLWL	R L - W L
CTGATAAAGGAGTCT	ACACTG---GAGTCT	MIKES	T L - E S
ACGCTGCTCGTCAAG	CGTGCT---GTTAAG	TLLVK	R A - V K
ATACGCATGAAGCCA	CACAGG---AAGCCA	IRMKP	H R - K P
CGAAGTAATGCTGCC	AATACT---GCTTCC	RSNAA	N T - A S
AAGTCATCGTTAGTG	TTATTT---TTAAAG	KSSLV	L F - L K
GTAAGCATTGGTGAGAAA	ATTGTT------GAAGAA	VSIGEK	I V - - E E
TCTGCGGGAACCAGCGAC	GAACCC------ACCAGC	SAGTSD	E P - - T S
AGCCAAAGTTTTGTC	CCAAAG---TTTGTT	SQSFV	P K - F V
CTCTCTGGCAGCAGGAACAGCAGA	AGCAGC------------AGCAGA	LSGSRNSR	S S - - - - S R
CCCTCTCAGTTGTCATCGGCAAGA	TTATCA------------GCAAGA	PSQLSSAR	L S - - - - A R
AGGGACCGTGACAAGGAC	CGTGAC------AAGGAC	RDRDKD	R D - - K D
GACGTGGACGTCCCGGGCCCCGCG	CGGGTC------------CCCGCG	DVDVPGPA	R V - - - - P A
ACACCCTACCATTTTACT	TACCCT------TTTACT	TPYHFT	Y P - - F T
AGGTTACAATCCGGT	TCCCTT---TCAGGT	RLQSG	S L - S G
CCTACACCCAGTGAT	ACAACC---GACGAT	PTPSD	T T - D D
TTCATACCTGAAAGATGTCAGTTG	ACACTT------------TGGTTA	FIPERCQL	T L - - - - W L
GAAAGTACAATTCTC	AGAGAC---GTTCTC	ESTIL	R D - V L
CGTCGTGTCCGCAACATA	GAGCGC------AACATC	RRVRNI	E R - - N I
AAGCTGGACACGGAA	CCGGCC---GCGGAA	KLDTE	P A - A E
ACAGCGGCGCCTGAG	GTGGCA---CCTGAG	TAAPE	V A - P E
GTGTCCAGCACTCCTTGTCCC	ACTTCC---------TGTCCT	VSSTPCP	T S - - - C P
CGAAGAAGAAGCCTG	AGGAGG---AGCCTG	RRRSL	R R - S L
CAGAATATCGAGAAG	AGAACA---CAGAAG	QNIEK	R T - Q K
CATTTTGATCAGAATGTT	GTGCTG------GCTGTG	HFDQNV	V L - - A V
AGTCCTGATAAGTCACCACCACCA	TCACCA------------CCACCA	SPDKSPPP	S P - - - - P P
GCTAGTACGTATGCT	ATTAAA---CATGCC	ASTYA	I K - H A
CGAAGCTATGGCTAC	AGCTCT---GGCTAC	RSYGY	S S - G Y
AATGCTCTTTCTGTAACCAGT	TCTGCG---------ACCAGT	NALSVTS	S A - - - T S
TCCAGCTCTGACCTG	AACTCT---GATCTG	SSSDL	N S - D L
TCCATACCATCAGAT	AAAGTT---TCAGAT	SIPSD	K V - S D
ATCAACACAGAAGTCCCTGATGTC	GACTCT------------GATGTC	INTEVPDV	D S - - - - D V
GGCGCGCAGCGGCACCACTTCGTC	CTGCCC------------TCCCTC	GAQRHHFV	L P - - - - S L
CCTTCACCTTTTACA	TCATCT---TTTGCA	PSPFT	S S - F A
ATGTTGCTGGTTGAG	TTGCTG---GTTGAG	MLLVE	L L - V E
TCTCCTAGCCCAAGGGCA	AGCCCA------AGGGCA	SPSPRA	S P - - R A
ACTGACAGTCATACA	GGCAAC---CATACA	TDSHT	G N - H T
AGTGAGGGGGAGCAT	GCGAGG---GAGCAC	SEGEH	A R - E H
GTCCAGCAACGCAGTGTCCCA	CAGGGA---------TTCCCA	VQQRSVP	Q G - - - F P
TCAAGTACGCACAGT	AACGCA---CACTGT	SSTHS	N A - H C
ACTATTACAGATGTGGAAGCTGTT	GTGATC------------GCTGCT	TITDVEAV	V I - - - - A A
AGCATAGGCTCTCCAGGC	GACTTT------CCAGAC	SIGSPG	D F - - P D
AAATCCAAAGGCAAC	TTCTTT---GGTATG	KSKGN	F F - G M
AGCTCATCCTTCGGG	TCCTCC---TTCGGG	SSSFG	S S - F G
CTTTTACCTGACACA	TTACTT---GACACA	LLPDT	L L - D T
AAAGAAGAACAGAGT	GGAGAA---CACAGT	KEEQS	G E - H S
GCGGCACTGACAGGCTTT	CTGCCA------GGCTTT	AALTGF	L P - - G F
ACCCCACCAGGAAAG	CTACCA---GGAGAG	TPPGK	L P - G E
AGACATCATCTGGGT	CCCAAA---CTGGGT	RHHLG	P K - L G
TCGGAGAAGTTGGAACAGCAAGAT	GATGAG------------GACGAT	SEKLEQQD	D E - - - - D D
AGAGCACACGCTTCGCCAAGGACA	TTGCAG------------AGGACA	RAHASPRT	L Q - - - - R T
ACGCTGTTTGTTCAA	CGCTGT---GTCCAA	TLFVQ	R C - V Q
CCTGAAGTGATTCTA	GAAGAG---ATTCTA	PEVIL	E E - I L
AATCCCGAATATGATTAT	GTCAGT------GATTAT	NPEYDY	V S - - D Y
TCAGCACCTTCAGCA	GTAACT---TCATCA	SAPSA	V T - S S
ACCTCGACTGTCCAT	TTGGCT---GTCCAT	TSTVH	L A - V H
CTGAGGCTAGGCTGG	AGGCGA---GGCTGG	MRLGW	R R - G W
ACCGCGCCCCCGCACCACAGA	CGGGGC---------CATGAC	TAPPHHR	R G - - - H D
CGGAGAAGAGCTGTG	AGAAGA---GCTGTG	RRRAV	R R - A V
GATAACAGCTTGACC	AACAAC---TTGACT	DNSLT	N N - L T
TCTAACCCTGGGATT	ATACAG---AACTTA	SNPGI	I Q - N L
GAGGAGCTCGGCAAGGGT	CCCTCC------AGGGGT	EELGKG	P S - - R G
CGGTCCAGGTCCAGGTCCTTCTCC	AGGTCC------------CTCTCC	RSRSRSFS	R S - - - - L S
ACGGGCTGCGGGGAAGCC	TTCGGG------GAAGCC	TGCGEA	F G - - E A
GAAATACCTGAGTAC	AGGGGT---GAACTC	EIPEY	R G - E L
ACTTCAGGAGAGACT	TTGGAA---GAGACT	TSGET	L E - E T
TGCGAGGGTCCCATC	GCGAGG---CCCATC	CEGPI	A R - P I
TGTGGCGGATTGGCT	GTGGAG---ATTGCT	CGGLA	V E - I A
GGTGTTACCGGCCTCACC	AACTTC------CTCATC	GVTGLT	N F - - L I
TTGCTGCTGCAGCAG	CTGCTG---CAGCAG	MLLQQ	L L - Q Q
CTTGGTGGACACTTGTCTGAAAGT	TTGTGG------------GAGAGT	LGGHLSES	L W - - - - E S
TTGCTGCTGCTGGGCCTG	CTGCTG------AGCCTG	MLLLGL	L L - - S L
ACGTCTGCTTACATG	TCTTCT---TACATG	TSAYM	S S - Y M
CTGCTATGTCTCGGGGCC	TGGCTC------GGGGCC	MLCLGA	W L - - G A
GGCAGCCCCAACAGG	AGCTCC---AGCAGG	GSPNR	S S - S R
TCGTTAGGTGTTTCCAAG	GACCTT------TCCAAG	SLGVSK	D L - - S K
AGCTCTGGCAGGAAC	TCTGAC---AGGAAC	SSGRN	S D - R N
GAAGTATTAAGAGATCCAATT	AGCATT---------GCAATC	EVLRDPI	S I - - - A I
AGCTCTGGGGACTTG	TCTGAG---GACTTA	SSGDL	S E - D L
GGGTTCTGGACAGGT	TCCCCA---AGCCGT	GFWTG	S P - S R
CCTGGTGAGCAGGAGGAACTGCGG	GGAGCA------------TTGAAG	PGEQEELR	G A - - - - L K
GATCACTGTGTGCTG	CCCTAT---GTGCTA	DHCVL	P Y - V L
AGTGGTCTACCAAGC	GAACCA---CCACCC	SGLPS	E P - P P
AGAGCTCGCCCAACGAGA	CGCACA------ATGAGA	RARPTR	R T - - M R
AGCTTGGATGCCCGT	TCGATT---GCCCGT	SLDAR	S I - A R
CGTGGCGTGCCTCCG	GTCTCG---CCCCCA	RGVPP	V S - P P
GACATAGGCAAGGTG	ATGGTT---GAAGTA	DIGKV	M V - E V
TCAGCCTTGGAAAGA	GCCTCG---GAGAGA	SALER	A S - E R
GAGCTACTGAGTGAG	CCACTA---AGTGAG	ELLSE	P L - S E
CGGAGGAGGGGAGAA	AGGAGG---GGAGAC	RRRGE	R R - G D
GTAATCGACCTTCCA	AACTAC---ATTCCA	VIDLP	N Y - I P
CTCCTGGCTCCACTGATC	GCTCTA------CTGATC	LLAPLI	A L - - L I
TCGAGCCCCCAGGGA	AGTTCC---CAGGGG	SSPQG	S S - Q G
TATGTTTTTAGGACC	GGCTCT---CGGAGC	YVFRT	G S - R S
ACACTGCTGCAGGAGCCT	CTGCTA------GAGTCT	TLLQEP	L L - - E S
AGCTCCACCTCATCCTCATCC	TCGTCC---------TCATCC	SSTSSSS	S S - - - S S
GCCCCACACCTCTCAGAA	CACCCC------TCAGAA	APHLSE	H P - - S E
TCCAAGTTCAGTAATGATGAC	AGCCGT---------GATGAC	SKFSNDD	S R - - - D D
TCCAGATACCTGTAC	ATGGAG---GTTTTC	SRYLY	M E - V F
CTGTTGTTAGATGAT	TTGTTA---GATGAT	MLLDD	L L - D D
ACACCACCTGAGAAG	CTGCTT---GAGAAG	TPPEK	L L - E K
TCCAGCCAGATAGAG	AGCGCT---CTCCAG	SSQIE	S A - L Q
CCGCGCGGCCCCGCCTAC	GACGGC------TCCTAC	PRGPAY	D G - - S Y
TCTAGCTCACCGCTA	AGCTCA---CCACTA	SSSPL	S S - P L
TTCAAAATGAACCATAAA	AAGAAG------CAGAAG	FKMNHK	K K - - Q K
TCTGGTGGAGTAGGCATCTCT	GACCAG---------TATCAT	SGGVGIS	D Q - - - Y H
TTGCCACCCCCTCTGCCAGGCTCA	CTTGCA------------GCGTTA	MPPPLPGS	L A - - - - A L
CCTAACCTGGAACAG	AACAAT---GGACAG	PNLEQ	N N - G Q
CGTGGGGGTCCAGGA	GTGGGG---CCAGGG	RGGPG	V G - P G
CGAGGGGGTCGAGGA	GAGGGT---CGTGGA	RGGRG	E G - R G
CTGGCCTTAGCTGAGGAC	TTAGCT------GAGGGC	MALAED	L A - - E G
ACGCAGGAGCACTCGGACTCCCAG	TTGAGC------------TCCCAG	TQEHSDSQ	L S - - - - S Q
GAGGCCCTGCCAGGTCTG	CCGCTA------GGTCTG	EALPGL	P L - - G L
GAAGAGGAAACAGGGAAGTCA	ACAGAA---------AAGTCA	EEETGKS	T E - - - K S
GCTCACCACCCCAGC	CTCCCA---CCCAGT	AHHPS	L P - P S
