wid.1	wid.2	amino_acid.1	amino_acid.2
CCCCGCAAGGGCCCCAAGGGA	CCCTGCAAGGGC---------	PRKGPKG	P C K G - - -
TGCTCCAATATCACTCAG	TGCTCCAGCTCC------	CSNITQ	C S S S - -
TGTGGACTTGAAGAC	TGTGAACATGGA---	CGLED	C E H G -
GTTGGCGTGCTTTTC	CATGGTTGGCGT---	VGVLF	H G W R -
GGAAGTTTTTCCTCA	GGAAGGGATTTC---	GSFSS	G R D F -
GAGTCCGGCGAGAAA	AGGAGTCGACTG---	ESGEK	R S R L -
ACAGAAGGCCCGGCA	GGGGAAGTCCTG---	TEGPA	G E V L -
CCCGGAGAGGACAGCCGGGAT	CCTGGAAAGGAC---------	PGEDSRD	P G K D - - -
ACGCCGCCGCTACTG	ACGCCGATGCTA---	TPPLL	T P M L -
ATCTACTACAATGTC	CTACTACAATGT---	IYYNV	L L Q C -
TCAGAGCTGTCAGGGGAACAGCTG	TCGGACCAGTCA------------	SELSGEQL	S D Q S - - - -
ATAAGTTTAGGGGAC	AAAAGTAAAAGG---	ISLGD	K S K R -
AGGGAAGATTGTATG	AGGGAAGCTGGT---	REDCM	R E A G -
GTAGAGCGGTCACTCACC	GCAGAGCAGTCA------	VERSLT	A E Q S - -
CCTGCCACAGCCGCTACCCCAACT	CCTGCCCCAGCC------------	PATAATPT	P A P A - - - -
TCCTTGGGCTTCCTGCCTCGCAAG	ACAATCAGGGGC------------	SLGFLPRK	T I R G - - - -
AAATTTCCAATCGAGACGCCA	TATTTTTCCTAC---------	KFPIETP	Y F S Y - - -
AGCTTCGGGGAGGAA	AGCTTCAGGGAG---	SFGEE	S F R E -
GAGGCAATAGGGTCGGGA	GAGGCAACAGGG------	EAIGSG	E A T G - -
GAATCCGACACGGCA	GAATCCATCCTG---	ESDTA	E S I L -
CCCGTGTTCCCTTGC	CCCGTTTCCCTT---	PVFPC	P V S L -
GGGTATTTTTCTTAC	GGGGCCCAGACT---	GYFSY	G A Q T -
GGATTGCCAACTCAA	GGATTGACAGCT---	GLPTQ	G L T A -
AAACCTCTTGAGTGCGGC	GGGACTCTGGTG------	KPLECG	G T L V - -
TTGCAGCGTTCCGGGTCAGCG	TTGCAGAGTTCC---------	MQRSGSA	L Q S S - - -
TCTTCCCTGCCTCCA	TCTTCCCAGCCT---	SSLPP	S S Q P -
TGCTGGAACCTGTCTCTA	TGCTGGAGCCTG------	CWNLSL	C W S L - -
AAAGATGGGCCGGGAAAGGCT	AAAGATGAGCTG---------	KDGPGKA	K D E L - - -
GGTGCCGAAAGCAGA	AATGTGGCTAAC---	GAESR	N V A N -
GCCAATATGATATCC	GCCAGTATTAGA---	ANMIS	A S I R -
TACGACATCGCTAAC	TATGACAACACT---	YDIAN	Y D N T -
GAAAATGTATCTGCG	GCAGAGGACAGT---	ENVSA	A E D S -
CCGGGGCCGTGGAGA	CCTGGGCTACGG---	PGPWR	P G L R -
AAGAAAAATAAAGGG	AAGGAACAGACA---	KKNKG	K E Q T -
CGCTTCTGGGGACTG	AGATTCAAAGAA---	RFWGL	R F K E -
CCCGGCGTGCCGTCC	CGTGACCGTCTG---	PGVPS	R D R L -
AACAGCCCTCCAGCCAGTGAGCCT	AACAGCTCTCCA------------	NSPPASEP	N S S P - - - -
TTTTCAGAAGTAGCACGC	TTCGGAATAGCA------	FSEVAR	F G I A - -
AAGCACCAAGGCTCTAGGAAG	AAGCACAAACGC---------	KHQGSRK	K H K R - - -
CGGGGAATCCGAAGTCGG	GGGGGAAGCCGA------	RGIRSR	G G S R - -
AAGGTGAGGACTGTG	AAGATCGTGGCT---	KVRTV	K I V A -
AAACATTGTGACCAA	AAGTACGGAGTC---	KHCDQ	K Y G V -
TTTGGGACAAAATAC	TTTGGGAGGCAA---	FGTKY	F G R Q -
AGTGACAAAAAAACT	CCTGTCAGAGAA---	SDKKT	P V R E -
ATTTACCCCCTGTTGCTGCTA	GTCTACCTCCTG---------	IYPLLLL	V Y L L - - -
CTCAAGGATGCTCGTTCG	TTACAAAAGGTT------	LKDARS	L Q K V - -
GCCGAGGAACCAGCCCTG	GGAGAAGCAACA------	AEEPAL	G E A T - -
GAGGTCTGGAAGGCAGAGGACACT	AAGGTCACCGAG------------	EVWKAEDT	K V T E - - - -
GCCATCACTTCAAAAGACAATAAC	GCTGTCAATTCA------------	AITSKDNN	A V N S - - - -
GACCCCTCTAGAGCCCCCTCT	GAACCCATTCGA---------	DPSRAPS	E P I R - - -
TGGACATGGAGGCCC	TGGGCCCGCGTG---	WTWRP	W A R V -
AAAAAAGATGCAACG	AAGAAAGGCTTA---	KKDAT	K K G L -
CAGCCATTGCTGTCCTCTCAGCTC	CAGCCCAGGAAG------------	QPLLSSQL	Q P R K - - - -
GGCATTGTGGCCAAG	AACCTTGGAGGC---	GIVAK	N L G G -
TTTTTTTTTTTCCTCTTG	ACTTGGAAAATC------	FFFFLL	T W K I - -
TTGAAGGTGGAGAAA	CTGAAGGAAGAG---	MKVEK	L K E E -
GGTCCTGGAGTCAGAACT	GGTCCTAGAGTC------	GPGVRT	G P R V - -
ATCACCAGGGATAAG	ATCACCAGCGGT---	ITRDK	I T S G -
GCACCTGGAGACGAT	GGGCCTGAAGAC---	APGDD	G P E D -
CAGAACAGAGTTATC	CAGAGCACAGAT---	QNRVI	Q S T D -
GAAGACTTAGAGCTTTGGTCAAAA	AAAGACTCAGAG------------	EDLELWSK	K D S E - - - -
GCTGCAGTAGGGGGCAGCGGCGGT	GCTGCAGGAGGG------------	AAVGGSGG	A A G G - - - -
TTACCTATGGCCCCAGCCTCCGAG	GGGCCCGCGCCC------------	LPMAPASE	G P A P - - - -
AACACGCTACCCCAT	GCTACCCCATCC---	NTLPH	A T P S -
TCACCAAGAGGTGCG	TTACCAGGAGGT---	SPRGA	L P G G -
NTGGCCGGGNTCTACANTCGN	TGCCGAGTCTAC---------	XAGXYXR	C R V Y - - -
AAGCCCCCGGGTGCGGGTGCGGGC	AAGCCCTCGGGT------------	KPPGAGAG	K P S G - - - -
GGAGGCCACAAACAACCTAAC	GGAGGCCCCAAA---------	GGHKQPN	G G P K - - -
TGGATGCTCGCGGTC	TGGATGCCCTCG---	WMLAV	W M P S -
CATCACGGAGAGGAC	CATCATGAAGAG---	HHGED	H H E E -
AGAAGACATTTCTTT	AGAAGATATTTC---	RRHFF	R R Y F -
ACCCTGAAGCACATACAA	AGTCTTTATTCC------	TLKHIQ	S L Y S - -
GGTGTGAACAGTAGC	GGTGTGAGCAGT---	GVNSS	G V S S -
ATTGGAGTGAAGAGTGGGACT	ACTGGAGGGAAG---------	IGVKSGT	T G G K - - -
GCCTCACGTAATGAACACAGA	GCCTTACATAAT---------	ASRNEHR	A L H N - - -
TATGAGTACTTTGACAACGTA	TATGAGAACTAT---------	YEYFDNV	Y E N Y - - -
GGAACAGGTGACAAG	GGAACAGATCGC---	GTGDK	G T D R -
GTGGCTTCCGGCCCCTCA	GTGGCTCCTGAC------	VASGPS	V A P D - -
CAGAACTACTCTTCC	CAGAACTCCTCT---	QNYSS	Q N S S -
CCTCATCTCCCCACT	CTTTATCACGCC---	PHLPT	L Y H A -
ACGCAGCCGAGATCAAGG	ACGCAGCAGCGA------	TQPRSR	T Q Q R - -
GCCGGTGGCTCATCT	GCCAGCAGCTCA---	AGGSS	A S S S -
AATGACAATATTCCTGTC	TGGTCTATAAGT------	NDNIPV	W S I S - -
TCACCAACGCCTCCG	TCACCACCGCCT---	SPTPP	S P P P -
CTCTGCAAGAATTCC	CTCTGCAATATT---	LCKNS	L C N I -
GTGGGCATCGGGCGCCCCACA	GTGGATCCTGGG---------	VGIGRPT	V D P G - - -
CAGACTTCATGGGAGGCCTCCCTA	CAGACTTCACGG------------	QTSWEASL	Q T S R - - - -
AATGATGGTGAAGAG	AACGATGATGAA---	NDGEE	N D D E -
GGGCCTACTTTGCACCTC	GCACCTCGTTTG------	GPTLHL	A P R L - -
CCTGCCTGTGAAGAG	CCTGCCAGTGAA---	PACEE	P A S E -
CATGTCCTAGGACCCCAG	CATCTTTCAGTA------	HVLGPQ	H L S V - -
TCCACAATATCTTCC	GCCACAACATCT---	STISS	A T T S -
GACACCTCTCCACCT	GAGATAACCCCA---	DTSPP	E I T P -
CAGCAGCAGCCGGCA	CAGCAGCCCCCG---	QQQPA	Q Q P P -
AGCCTGCCTTCATCC	GGCCTGACTTCA---	SLPSS	G L T S -
GTGCTGTGCAAGAAA	GTGCTGAGCAAG---	VLCKK	V L S K -
GATGTGACTAGCAAT	GATGTGCCTGGC---	DVTSN	D V P G -
ATCTCCACAGCTGCA	ATCTCTGCAGCT---	ISTAA	I S A A -
CAGGTCCCAGCTGGCCATAGCCAG	CAGGTCTCGTCT------------	QVPAGHSQ	Q V S S - - - -
GACACACCTTCATCC	GACACATCTGCA---	DTPSS	D T S A -
