wid.1	wid.2	amino_acid.1	amino_acid.2
CCCCGCAAGGGCCCCAAGGGA	CCCTGC---------AAGGGC	PRKGPKG	P C - - - K G
TGCTCCAATATCACTCAG	TGCTCC------AGCTCC	CSNITQ	C S - - S S
TGTGGACTTGAAGAC	TGTGAA---CATGGA	CGLED	C E - H G
GTTGGCGTGCTTTTC	CATGGT---TGGCGT	VGVLF	H G - W R
GGAAGTTTTTCCTCA	GGAAGG---GATTTC	GSFSS	G R - D F
GAGTCCGGCGAGAAA	AGGAGT---CGACTG	ESGEK	R S - R L
ACAGAAGGCCCGGCA	GGGGAA---GTCCTG	TEGPA	G E - V L
CCCGGAGAGGACAGCCGGGAT	CCTGGA---------AAGGAC	PGEDSRD	P G - - - K D
ACGCCGCCGCTACTG	ACGCCG---ATGCTA	TPPLL	T P - M L
ATCTACTACAATGTC	CTACTA---CAATGT	IYYNV	L L - Q C
TCAGAGCTGTCAGGGGAACAGCTG	TCGGAC------------CAGTCA	SELSGEQL	S D - - - - Q S
ATAAGTTTAGGGGAC	AAAAGT---AAAAGG	ISLGD	K S - K R
AGGGAAGATTGTATG	AGGGAA---GCTGGT	REDCM	R E - A G
GTAGAGCGGTCACTCACC	GCAGAG------CAGTCA	VERSLT	A E - - Q S
CCTGCCACAGCCGCTACCCCAACT	CCTGCC------------CCAGCC	PATAATPT	P A - - - - P A
TCCTTGGGCTTCCTGCCTCGCAAG	ACAATC------------AGGGGC	SLGFLPRK	T I - - - - R G
AAATTTCCAATCGAGACGCCA	TATTTT---------TCCTAC	KFPIETP	Y F - - - S Y
AGCTTCGGGGAGGAA	AGCTTC---AGGGAG	SFGEE	S F - R E
GAGGCAATAGGGTCGGGA	GAGGCA------ACAGGG	EAIGSG	E A - - T G
GAATCCGACACGGCA	GAATCC---ATCCTG	ESDTA	E S - I L
CCCGTGTTCCCTTGC	CCCGTT---TCCCTT	PVFPC	P V - S L
GGGTATTTTTCTTAC	GGGGCC---CAGACT	GYFSY	G A - Q T
GGATTGCCAACTCAA	GGATTG---ACAGCT	GLPTQ	G L - T A
AAACCTCTTGAGTGCGGC	GGGACT------CTGGTG	KPLECG	G T - - L V
TTGCAGCGTTCCGGGTCAGCG	TTGCAG---------AGTTCC	MQRSGSA	L Q - - - S S
TCTTCCCTGCCTCCA	TCTTCC---CAGCCT	SSLPP	S S - Q P
TGCTGGAACCTGTCTCTA	TGCTGG------AGCCTG	CWNLSL	C W - - S L
AAAGATGGGCCGGGAAAGGCT	AAAGAT---------GAGCTG	KDGPGKA	K D - - - E L
GGTGCCGAAAGCAGA	AATGTG---GCTAAC	GAESR	N V - A N
GCCAATATGATATCC	GCCAGT---ATTAGA	ANMIS	A S - I R
TACGACATCGCTAAC	TATGAC---AACACT	YDIAN	Y D - N T
GAAAATGTATCTGCG	GCAGAG---GACAGT	ENVSA	A E - D S
CCGGGGCCGTGGAGA	CCTGGG---CTACGG	PGPWR	P G - L R
AAGAAAAATAAAGGG	AAGGAA---CAGACA	KKNKG	K E - Q T
CGCTTCTGGGGACTG	AGATTC---AAAGAA	RFWGL	R F - K E
CCCGGCGTGCCGTCC	CGTGAC---CGTCTG	PGVPS	R D - R L
AACAGCCCTCCAGCCAGTGAGCCT	AACAGC------------TCTCCA	NSPPASEP	N S - - - - S P
TTTTCAGAAGTAGCACGC	TTCGGA------ATAGCA	FSEVAR	F G - - I A
AAGCACCAAGGCTCTAGGAAG	AAGCAC---------AAACGC	KHQGSRK	K H - - - K R
CGGGGAATCCGAAGTCGG	GGGGGA------AGCCGA	RGIRSR	G G - - S R
AAGGTGAGGACTGTG	AAGATC---GTGGCT	KVRTV	K I - V A
AAACATTGTGACCAA	AAGTAC---GGAGTC	KHCDQ	K Y - G V
TTTGGGACAAAATAC	TTTGGG---AGGCAA	FGTKY	F G - R Q
AGTGACAAAAAAACT	CCTGTC---AGAGAA	SDKKT	P V - R E
ATTTACCCCCTGTTGCTGCTA	GTCTAC---------CTCCTG	IYPLLLL	V Y - - - L L
CTCAAGGATGCTCGTTCG	TTACAA------AAGGTT	LKDARS	L Q - - K V
GCCGAGGAACCAGCCCTG	GGAGAA------GCAACA	AEEPAL	G E - - A T
GAGGTCTGGAAGGCAGAGGACACT	AAGGTC------------ACCGAG	EVWKAEDT	K V - - - - T E
GCCATCACTTCAAAAGACAATAAC	GCTGTC------------AATTCA	AITSKDNN	A V - - - - N S
GACCCCTCTAGAGCCCCCTCT	GAACCC---------ATTCGA	DPSRAPS	E P - - - I R
TGGACATGGAGGCCC	TGGGCC---CGCGTG	WTWRP	W A - R V
AAAAAAGATGCAACG	AAGAAA---GGCTTA	KKDAT	K K - G L
CAGCCATTGCTGTCCTCTCAGCTC	CAGCCC------------AGGAAG	QPLLSSQL	Q P - - - - R K
GGCATTGTGGCCAAG	AACCTT---GGAGGC	GIVAK	N L - G G
TTTTTTTTTTTCCTCTTG	ACTTGG------AAAATC	FFFFLL	T W - - K I
TTGAAGGTGGAGAAA	CTGAAG---GAAGAG	MKVEK	L K - E E
GGTCCTGGAGTCAGAACT	GGTCCT------AGAGTC	GPGVRT	G P - - R V
ATCACCAGGGATAAG	ATCACC---AGCGGT	ITRDK	I T - S G
GCACCTGGAGACGAT	GGGCCT---GAAGAC	APGDD	G P - E D
CAGAACAGAGTTATC	CAGAGC---ACAGAT	QNRVI	Q S - T D
GAAGACTTAGAGCTTTGGTCAAAA	AAAGAC------------TCAGAG	EDLELWSK	K D - - - - S E
GCTGCAGTAGGGGGCAGCGGCGGT	GCTGCA------------GGAGGG	AAVGGSGG	A A - - - - G G
TTACCTATGGCCCCAGCCTCCGAG	GGGCCC------------GCGCCC	LPMAPASE	G P - - - - A P
AACACGCTACCCCAT	GCTACC---CCATCC	NTLPH	A T - P S
TCACCAAGAGGTGCG	TTACCA---GGAGGT	SPRGA	L P - G G
NTGGCCGGGNTCTACANTCGN	TGCCGA---------GTCTAC	XAGXYXR	C R - - - V Y
AAGCCCCCGGGTGCGGGTGCGGGC	AAGCCC------------TCGGGT	KPPGAGAG	K P - - - - S G
GGAGGCCACAAACAACCTAAC	GGAGGC---------CCCAAA	GGHKQPN	G G - - - P K
TGGATGCTCGCGGTC	TGGATG---CCCTCG	WMLAV	W M - P S
CATCACGGAGAGGAC	CATCAT---GAAGAG	HHGED	H H - E E
AGAAGACATTTCTTT	AGAAGA---TATTTC	RRHFF	R R - Y F
ACCCTGAAGCACATACAA	AGTCTT------TATTCC	TLKHIQ	S L - - Y S
GGTGTGAACAGTAGC	GGTGTG---AGCAGT	GVNSS	G V - S S
ATTGGAGTGAAGAGTGGGACT	ACTGGA---------GGGAAG	IGVKSGT	T G - - - G K
GCCTCACGTAATGAACACAGA	GCCTTA---------CATAAT	ASRNEHR	A L - - - H N
TATGAGTACTTTGACAACGTA	TATGAG---------AACTAT	YEYFDNV	Y E - - - N Y
GGAACAGGTGACAAG	GGAACA---GATCGC	GTGDK	G T - D R
GTGGCTTCCGGCCCCTCA	GTGGCT------CCTGAC	VASGPS	V A - - P D
CAGAACTACTCTTCC	CAGAAC---TCCTCT	QNYSS	Q N - S S
CCTCATCTCCCCACT	CTTTAT---CACGCC	PHLPT	L Y - H A
ACGCAGCCGAGATCAAGG	ACGCAG------CAGCGA	TQPRSR	T Q - - Q R
GCCGGTGGCTCATCT	GCCAGC---AGCTCA	AGGSS	A S - S S
AATGACAATATTCCTGTC	TGGTCT------ATAAGT	NDNIPV	W S - - I S
TCACCAACGCCTCCG	TCACCA---CCGCCT	SPTPP	S P - P P
CTCTGCAAGAATTCC	CTCTGC---AATATT	LCKNS	L C - N I
GTGGGCATCGGGCGCCCCACA	GTGGAT---------CCTGGG	VGIGRPT	V D - - - P G
CAGACTTCATGGGAGGCCTCCCTA	CAGACT------------TCACGG	QTSWEASL	Q T - - - - S R
AATGATGGTGAAGAG	AACGAT---GATGAA	NDGEE	N D - D E
GGGCCTACTTTGCACCTC	GCACCT------CGTTTG	GPTLHL	A P - - R L
CCTGCCTGTGAAGAG	CCTGCC---AGTGAA	PACEE	P A - S E
CATGTCCTAGGACCCCAG	CATCTT------TCAGTA	HVLGPQ	H L - - S V
TCCACAATATCTTCC	GCCACA---ACATCT	STISS	A T - T S
GACACCTCTCCACCT	GAGATA---ACCCCA	DTSPP	E I - T P
CAGCAGCAGCCGGCA	CAGCAG---CCCCCG	QQQPA	Q Q - P P
AGCCTGCCTTCATCC	GGCCTG---ACTTCA	SLPSS	G L - T S
GTGCTGTGCAAGAAA	GTGCTG---AGCAAG	VLCKK	V L - S K
GATGTGACTAGCAAT	GATGTG---CCTGGC	DVTSN	D V - P G
ATCTCCACAGCTGCA	ATCTCT---GCAGCT	ISTAA	I S - A A
CAGGTCCCAGCTGGCCATAGCCAG	CAGGTC------------TCGTCT	QVPAGHSQ	Q V - - - - S S
GACACACCTTCATCC	GACACA---TCTGCA	DTPSS	D T - S A
